войти: войти
прошлый: прошлом
нанайский: нанайский нанайском
описание: описание
авторство: авторства
материал: материал
бассейновый: бассейнового
амурский: амурского
поиск: поиск поиску
водный: водного водные водный
красный: красные
инструмент: инструменты
низкий: низкие
страница: страница странице страницу страницы
дальневосточный: дальневосточная дальневосточной
обращение: обращения
также: также
район: район районе
тип: тип
хабаровский: хабаровский хабаровского
представиться: представились
особо: особо
текст: текст
кодекс: кодекс
черепаха: черепах черепахи
берег: берега берегах
пойма: пойме
запад: западу
ред: ред
россия: россии россия
событие: события
течение: течения
случай: случаях
наименование: наименований
карта: картами карты
проток: протоками протоке протоки
заполнить: заполнить
ресурс: ресурсы
гас: гасе
север: северу
лежать: лежащим
охрана: охраны
статья: статьи статья
скрытый: скрытые
служебный: служебные
амур: амур амура
условие: условий условия
версия: версия
округ: округа
перейти: перейти
идентификатор: идентификаторы
белый: белая
связаться: свяжитесь
фгуп: фгуп
добавить: добавить
викидать: викиданные викиданных
гассинский: гассинская
хара: хар
зона: зона
архивировать: архивировано
жерлянка: жерлянка
фонд: фонд
правобережный: правобережной
мочь: могут
сайт: сайте
восток: восток востока
навигация: навигации навигация
октябрь: октября
заглавный: заглавная
содержание: содержание
код: код
автомобильный: автомобильная
впадать: впадают впадающие
широта: ш
значение: значения
зеркало: зеркала
хабаровск: хабаровск
территория: территории территорию
этот: эта
вдаваться: вдающимися
часть: части
село: село
рф: рф
правка: правка правки
нижний: нижнего
расположить: расположено
сток: сток
год: года году
алфавит: алфавиту
размер: размеры
соединяться: соединяется
обитать: обитают
русский: русский
пожертвовать: пожертвовать
язык: языках
некоммерческий: некоммерческой
сообщество: сообщество
заявление: заявление
размножение: размножения
ответственность: ответственности
установить: установлена
сильно: сильно
персональный: персональные
отредактировать: отредактирована
линия: линия
система: системе системы
вып: вып
портал: портал
место: мест
ссылка: ссылка ссылки
сообщить: сообщить
субъект: субъект
избранный: избранные
википедия: википедии википедия
объект: объекта объектов объекты
ссср: ссср
гкгна: гкгн
госгисцентр: госгисцентр
лицензия: лицензии
пихец: пихца
ещё: ещё
карточка: карточка
охранять: охраняемые
больший: большая
неопр: неопр
править: править
памятник: памятник
цапля: цапля
соседний: соседним
км: км
действовать: действовать
подробный: подробнее
гасся: гасси
ошибка: ошибке
береговой: береговая
статус: статус
выпь: выпь
море: моря
обсуждение: обсуждение
кук: куки
последний: последний последняя
помимо: помимо
участие: участие
номер: номер
удлинённый: удлинённую
запись: запись
форум: форум
обитание: обитания
озеро: озера озеро озером озёра
государственный: государственный
создать: создать
имя: имён
край: край края
иметь: имеет
печать: печати
постоянный: постоянная
страна: страна
протока: протокой
пространство: пространства
изрезать: изрезана
изученность: изученность
знак: знак
объём: объём
получить: получило получить
водосборный: водосборная
товарный: товарный
сюда: сюда
скачать: скачать
полуостров: полуостровами
оригинал: оригинала
вклад: вклад
так: т
сведение: сведения
оопт: оопт
минприрода: минприроды
природный: природные
другой: другие других
найхинский: найхинская
июнь: июня
русый: рус
гвр: гвр
пресноводный: пресноводное
лист: лист
публикация: публикации
цитировать: цитировать
бассейн: бассейн бассейна
зарегистрировать: зарегистрированный
политика: политика
название: названий
просмотр: просмотры
охранный: охранная охранный
мыс: мыс
включить: включенной
сентябрь: сентября
иас: иас
регистрационный: регистрационный
новостной: новостной
вокруг: вокруг
краевой: краевого
свежий: свежие
смотреть: см
дорога: дорога
морфометрия: морфометрия
книга: книги
справка: справка
новый: новые
пир: пир
элемент: элемент
читать: читать
мы: нами
реестр: реестр
текущий: текущие
указать: указано
топоним: топонима
дальний: дальнего дальний
история: история
состояние: состоянию
газопровод: газопровод
гидрологический: гидрологическая
пересекать: пересекает
мобильный: мобильная
энциклопедия: энциклопедии
дубовый: дубовый
доступный: доступен
свойство: свойство
шабалин: шабалина
источник: источник
учётный: учётную
короткий: короткий
викимедиа: викимедиа
гидрометеоиздат: гидрометеоиздат
поверхностный: поверхностных
река: реки
использование: использования
площадь: площадь
случайный: случайная
западный: западная
находиться: находится
земноводное: земноводных
вода: вод
категория: категории
информация: информация
средний: средней
отдельный: отдельных
высота: высота
отказ: отказ
проект: проектах
сохранение: сохранением
свободный: свободной
форма: форму
указание: указанием
конфиденциальность: конфиденциальности
расположение: расположение
связанный: связанные
дата: дата
поведение: поведения
географический: географических
каталог: каталог
разработчик: разработчики
дополнительный: дополнительные
природа: природы
бабчить: бабчи
изображение: изображений
примечание: примечания
организация: организации
уровень: уровнем
статистика: статистика
