войти: войти
матч: матч матча матчах матчей
бременский: бременского
действовать: действовать
подробный: подробнее
фк: фк
декабрь: декабря
статья: статье статьи статью статья
год: гг год года году
клуб: клуб клуба
проверять: проверяема
ошибка: ошибке
количество: количество
забить: забив
авторство: авторства
описание: описание
игрок: игрок игрока игроки
материал: материал
мочь: могут можете
сентябрь: сентября
октябрь: октября
биография: биографии
футбол: футбол футболу
национальный: национальная национальную национальных
заглавный: заглавная
начать: начал
рекомендация: рекомендации
содержание: содержание
тренировать: тренировал
поиск: поиск поиску
внешний: внешние
правка: правка правки
обсуждение: обсуждение
кук: куки
свежий: свежие
смотреть: см
рост: рост
код: код
германия: германии германия
проект: проект проектах
последний: последний последняя
инструмент: инструменты
справка: справка
профессиональный: профессиональный
новый: новые
страница: страница странице страницу страницы
победа: победой победу
гол: гола голов
участие: участие
элемент: элемент
поле: поле
условие: условий условия
лига: лиг
закончиться: закончился
читать: читать
запись: запись
тренер: тренер
тип: тип
форум: форум
википедия: википедии википедия
представиться: представились
мы: нами
этот: эта
авторитетный: авторитетные
текущий: текущие
современник: современников
суперкубок: суперкубка
родиться: род родившиеся родился
ноябрь: ноября
футбольный: футбольный
гамбург: гамбург гамбурге
создать: создать
добавить: добавив
имя: имён
берлинский: берлинского
сайт: сайты
править: править
мадрид: мадрида
текст: текст
республика: республика
кодекс: кодекс
видео: видео
иначе: иначе
история: история
чемпионат: чемпионатов
печать: печати
постоянный: постоянная
атлетико: атлетико
мобильный: мобильная
чемпион: чемпион чемпионов чемпионом
викидать: викиданных
алфавит: алфавиту
позиция: позиция
клубный: клубная
спортсмен: спортсмены
стать: стал
апрель: апреля
гражданство: гражданство
энциклопедия: энциклопедии
выходить: выходить
отредактировать: отредактирована отредактировать
пространство: пространства
томас: томас
русский: русский
пожертвовать: пожертвовать
вердёр: вердер вердера
доступный: доступен
сборная: сборная сборной сборную
занятие: занятий
язык: языках
знак: знак
источник: источник источники источников
считаться: считается
некоммерческий: некоммерческой
учётный: учётную
событие: события
счёт: счётом
получить: получить
достижение: достижения
бундеслига: бундеслиге
тематический: тематические
короткий: короткий
сообщество: сообщество
второй: вторую
одержать: одержала
сюда: сюда
словарь: словари
скачать: скачать
случай: случаях
дортмунд: дортмунда
фото: фото
викимедиа: викимедиа
ответственность: ответственности
брауншвейг: брауншвейга
вклад: вклад
товарный: товарный
сыграть: сыграв сыграл
который: котором
использование: использования
персональный: персональные
сезон: сезоне
случайный: случайная
кубок: кубка кубке кубков
удалить: удалена
ресурс: ресурсы
система: системе
частый: чаще
ссылка: ссылка ссылки ссылок
персоналия: персоналии
состояться: состоялся
обладатель: обладателей обладатель
футболист: футболист футболисты
категория: категории
скрытый: скрытые
сведение: сведения
бразилия: бразилия
информация: информация
человек: человек
служебный: служебные
другой: других
сообщить: сообщить
версия: версия
избранный: избранные
карьера: карьера карьеру
тренерский: тренерская
боруссия: боруссии
играть: играть
отдельный: отдельных
завершить: завершил
навигация: навигации навигация
лицензия: лицензии
отказ: отказ
аудио: аудио
различный: различных
арминии: арминии
перейти: перейти
сохранение: сохранением
свободный: свободной
провести: проведя провёл
победитель: победителем
англ: англ
союз: союз
указание: указанием
конфиденциальность: конфиденциальности
заявление: заявление
связанный: связанные
динамо: динамо
сноска: сносок
айнтрахт: айнтрахта
ещё: ещё
связаться: свяжитесь
должный: должна
поведение: поведения
игра: игр
первый: первый
разработчик: разработчики
вид: виде
дополнительный: дополнительные
вольтер: вольтер
федеративный: федеративная
изображение: изображений
европейский: европейских
немой: нем
цитировать: цитировать
организация: организации
официальный: официальных
август: августа
хватать: хватает
впервые: впервые
зарегистрировать: зарегистрированный
фонд: фонд
политика: политика
защитник: защитник
просмотр: просмотры
команда: команду
немецкий: немецкий
уефа: уефа
статистика: статистика
против: против
