мы: нами
главныхроль: главныхролях
наполнить: наполненный
происходить: происходит
хороший: лучшей лучший
череда: череда
граница: границе
материя: материя
юноша: юноша юношей
сиротливый: сиротливый
раздел: разделами разделе
стрельба: стрельбу
прописать: прописаны
номинировать: номинирован
источник: источник источники источников
ирландский: ирландский ирландского
годавикипедия: годавикипедия
стайгера: стайгера
утомлённый: утомлённый
поздний: позже
статья: статье статьи статью
награда: награды
энциклопедия: энциклопедии
читатьправитьправить: читатьправитьправить
фильмскрытый: фильмскрытые
правкиновое: правкиновые
стилистика: стилистике
сценарий: сценарию сценария
ресурс: ресурсы
полный: полная
мартин: мартин мартина
перейти: перейти
страницасодержаниеизбрать: страницасодержаниеизбранные
звать: зовут
фильм: фильм фильме фильмы
навигация: навигации навигация
сродни: сродни
банша: банши
цитата: цитаты
страница: страница странице страницы
полиция: полиции
сильный: сильнее
википедия: википедии википедия
режиссёр: режиссёр режиссёра
хулиганский: хулиганскими
род: рода роду
макдонахафильм: макдонахафильмы
статьятекущий: статьятекущие
год: год года году
статьисообществофорумсправкасвежий: статьисообществофорумсправкасвежие
брендать: брендан брендана
бог: боге
отредактировать: отредактирована отредактировать
дуля: дули
печать: печати
великобритания: великобритании великобритания
грязный: грязным
проверить: проверить
короткометражный: короткометражный
ход: ходе ходу
жена: жена женой
телевидение: телевидению
глаз: глазах
политика: политика
макдонах: макдонаха
метр: метр
аранский: аранских
имя: имени имён
залечь: залечь
записьвойти: записьвойти
прочий: прочие
авторсценарий: авторсценария
дополнительный: дополнительные
свой: своего свои
конец: конца конце
линнейнский: линнейнской
тематический: тематические
муж: муж
палач: палачи
жизнь: жизни
трилогия: трилогии трилогия
убийца: убийцу
британский: британском
употреблять: употребляет употребляют
кончать: кончает
фонд: фонд
стрелять: стреляет
покончить: покончить
качество: качестве
показать: показан
восклицать: восклицает
пуля: пулями
доктор: доктор
поиск: поиск поиску
страницуполучить: страницуполучить
решать: решает
фестиваль: фестиваля
макдон: макдонах
эббинга: эббинга
язык: язык языках
манер: манерами
мужчина: мужчин мужчина мужчину
больница: больнице
невероятный: невероятной
узнавать: узнаёт
картина: картина
игровой: игровой
драматург: драматурга
лауреат: лауреаты
шаблон: шаблонами
приводить: приводит
март: марта
поставить: поставлена
перепалка: перепалка
просмотр: просмотры
гей: гея
пьеса: пьесе пьесы
конрой: конрой конроя
колыбель: колыбели
хватать: хватает
инишмор: инишмор
сын: сын сына сыном
ссылкасведение: ссылкасведения
иначе: иначе
играть: играет играли
просторечный: просторечного
тип: тип типа
действовать: действовать
внешний: внешние
результат: результате
исполнять: исполняющего
отказ: отказ
обсуждение: обсуждения
обоймаангл: обоймаангл
аудиенция: аудиенции
событияпожертвовать: событияпожертвовать
кролик: кролик кролика
коротышка: коротышка
переплетение: переплетениями
проверка: проверки
глисон: глисон глисона
лексикон: лексиконом
время: времени время
голова: головой
дискуссия: дискуссию
указание: указанием
обойма: обойма
роль: роль ролях
он: нему нём
группа: группу
викимедиа: викимедиа
патрон: патрона патронам патроны
свободный: свободной
факт: фактов факты
некоммерческий: некоммерческой
висок: виску
продавец: продавец продавца
говорить: говорит
шестизарядник: шестизарядник шестизарядника шестизаряднике
череп: череп
запоздание: запозданием
содержание: содержание
эпилог: эпилоге
встречаться: встречается
потерять: потерявшие
гибнуть: гибнет
оператор: оператор
билборд: билборда
швеция: швеции
персональный: персональные
условие: условий условия
действие: действие
сайт: сайте сайты
уилмота: уилмот
матерный: матерных
случайность: случайности
аналог: аналога
январь: января
подносить: подносит
поэтому: поэтому
несколько: нескольких
пояснение: пояснений
дорога: дороге
авторство: авторства
остров: острова островов
прослеживать: прослеживаемая
мочь: могут можете
её: её
правкипостоянный: правкипостоянная
материал: материал
название: название
февраль: февраля
гарь: гари
ошибкекак: ошибкекак
ночью: ночью
прокат: прокат прокате
проверять: проверяема
приз: приз
который: которой которыми которых
страна: страны
руорь: руори
инишерин: инишерина
соответствовать: соответствуют соответствующую
ронять: роняет
информация: информация
речь: речи
слово: слов слово
изрешетить: изрешечённый
короткий: короткий
отец: отца
представиться: представились
называть: называет
шесть: шести шесть
салливана: салливан
сюжет: сюжет сюжета
поезд: поезда поезде
учётный: учётную
пацан: пацан
этот: эта
дулль: дулли
рекомендация: рекомендации
открывать: открывает
поскольку: поскольку
автор: автор
англ: англ
лейтенант: лейтенант
подробный: подробнее
разработчик: разработчики
недостаток: недостатков
знак: знак
отдельный: отдельных
мистер: мистер мистера
использование: использования
сам: самого
такой: таких
победа: победа
проверкивикипедия: проверкивикипедия
паренёк: паренька паренёк
донал: донал
эшлинга: эшлинг
погибнуть: погибнуть
линить: линена
вместе: вместе
авторитетный: авторитетные
однако: однако
умерший: умершего
годакороткометражный: годакороткометражные
примитивность: примитивности
мина: мин
представить: представлен
броситься: бросившись
напряжение: напряжение
ирландиифильм: ирландиифильмы
некий: некоему
парнишка: парнишка
сообщить: сообщить
собственный: собственной собственному собственным
рыжий: рыжего
миссури: миссури
вместо: вместо
супружеский: супружеской
кодистория: кодистория
связаться: свяжитесь
код: код
страницецитировать: страницецитировать
наблюдательный: наблюдательного
оскар: оскар
викицитатникэлемент: викицитатникэлемент
американский: американской
персонаж: персонажа персонажи
семь: семь
сомнение: сомнение
женщина: женщина женщину
пара: парой
статьяобсуждение: статьяобсуждение
королева: королева
течение: течение
длительность: длительность
ещё: ещё
должный: должен должна
шаблонестатья: шаблонестатьи
револьвер: револьвер
дэвид: дэвид
достигать: достигает
младенец: младенца
выйти: вышел
утренний: утренних
викидать: викиданных
стать: стала
макдонахатрилогия: макдонахатрилогия
доннель: доннели
русский: русский русского
первый: первая первой
необходимо: необходимо
ребёнок: ребёнок
убивать: убивает
премия: премии премию премия
киноакадемия: киноакадемии
творчество: творчество
работа: работа
констебль: констебль
тайга: тайг
представлять: представляет
жанр: жанр
день: день
энн: энн
междометие: междометия
питомец: питомца
заглавный: заглавная
например: например
поведение: поведения
кук: куки
красота: красоты
неизд: неизд
сноска: сносок
ссылка: ссылками ссылки ссылок
апогей: апогея
выпуск: выпуска
база: баз
прийтись: пришлось
барабан: барабане
статистика: статистика
отстрелить: отстреленной
называться: называется
лайдон: лайдон
звучать: звучит
тема: теме
последний: последний
зритель: зрителя
текст: текст
коннемара: коннемара
номинация: номинации
брюгге: брюгге
дрессажа: дрессаж
заявление: заявление
оно: оно
английский: английский
психопат: психопатов
актриса: актриса
мобильный: мобильная
расследование: расследования
править: править
калека: калека
смерть: смертей смерти смерть
сведение: сведений
тёмный: тёмная
сюдасвязанный: сюдасвязанные
посвятить: посвящён
себя: собой
ответственность: ответственности
алфавитуфильм: алфавитуфильмы
затем: затем
иметь: имеют
достоверность: достоверность
особенность: особенности
попутчик: попутчик
кодекс: кодекс
версия: версия
дублин: дублин
симпатия: симпатией
российский: российском
категория: категории
домашний: домашнего
май: мая
появляться: появляется
марвин: марвина
инструмент: инструменты
мать: матери мать
проникнуться: проникшегося
сначала: сначала
театр: театре
системеобсуждениевкладсоздать: системеобсуждениевкладсоздать
необычный: необычный
макфарлэйн: макфарлэйн
найти: найти
ужасный: ужасный
прибыть: прибывший
лицензия: лицензии
заканчиваться: заканчиваются
рассказывать: рассказывает
запад: запад
пространство: пространства
вид: виде
художественный: художественный
ирвин: ирвин
страницыслужебный: страницыслужебные
короткометражка: короткометражкой
садиться: садятся
однорукий: однорукий
рассуждать: рассуждает
конфиденциальность: конфиденциальности
раскрыться: раскрывшийся
смотреть: см
снять: снятый
тот: тому
кошмарный: кошмарными
призрак: призрак
октябрь: октября
товарный: товарный
зарегистрировать: зарегистрированный
весь: всей
актёр: актёр актёра
бронски: бронски
дно: дно
ориентировка: ориентировок
спокан: спокана
умирать: умирает
бюджет: бюджет
вещь: вещах
столкнуться: столкнуться
талант: талант
детство: детстве
мюррэй: мюррэй
арест: ареста
изложить: изложенных
алфавитувикипедия: алфавитувикипедия
тарантиновский: тарантиновским
статьислучайный: статьислучайная
викицитатник: викицитатнике
добавить: добавив
доступный: доступен
императорский: императорском
минута: минут
завоевать: завоевал
инишир: инишир
организация: организации
точность: точность
известный: известного
скачать: скачать
финал: финале
случай: случаях
проект: проектах
пирс: пирс
домой: домой
удалить: удалена
инишмаан: инишмаан
сохранение: сохранением
герой: герой
близкий: близок
получить: получила
миссис: миссис
ирландия: ирландии ирландия
описание: описание
участие: участие
другой: других
пато: пато
упоминать: упоминает
сыграть: сыграл
требовать: требует
викицитатниквикипедия: викицитатниквикипедия
рядом: рядом
развязка: развязки
битый: бит
нерентабельность: нерентабельности
