мы: нами
аче: аче
ранож: раножи
эркола: эрколе
дания: дании дания
хассан: хассан
мевар: мевар
салум: салум
пруссия: пруссия
категория: категории категория
ратан: ратан
мендоса: мендоса
ногайский: ногайская
около: ок
померанский: померанская
сукета: сукет
таунг: таунгу
мантуй: мантуя
веер: веера
малл: малла
хоуцун: хоуцун
лееле: лееле
нур: нуре
наксосский: наксосское
урриэс: урриэс
дайвить: дайвьет
ганс: ганс
борн: борну
сингха: сингх
нарайян: нарайян
равалджи: равалджи
московский: московское
али: али
чобанула: чобанул
ибн: ибн
пётр: пётр
кед: кедах
энциклопедия: энциклопедии
франсеск: франсеск
салалил: салалила
франческо: франческо
рюкю: рюкю
неаполь: неаполя
дож: дож
версияправитьправить: версияправитьправить
чаламб: чаламба
правкиновое: правкиновые
аржун: аржун
мак: мак
фридрих: фридрих
сап: сапа
шотландия: шотландии шотландия
пармский: пармское
хосенштамм: хосенштамм
перейти: перейти
людвиг: людвиг
инк: инка инков
дарй: дарйа
аракан: аракан
вольрада: вольрад
бранденбург: бранденбург
сунд: сунда
набожный: набожный
хорезм: хорезм
зайянида: зайяниды
силезский: силезские
страницасодержаниеизбрать: страницасодержаниеизбранные
арманьяк: арманьяк
кёльнский: кёльнское
ламбур: ламбур
адольф: адольф
америка: америка
навигация: навигации навигация
царь: царь
йотф: йотфа
дракп: дракпа
джаявеер: джаявеера
монтекьяруголо: монтекьяруголо
герман: герман
мутара: мутара
адаль: адаль
гектор: гектор
мек: мек
франция: франции франция
элемент: элемент
абд: абд
страница: страница страницы
швеция: швеции швеция
отличаться: отличаться
сулейман: сулейман
сакть: сакти
мадхукара: мадхукар
венеция: венеции
шауэнбург: шауэнбург
википедия: википедии википедия
непал: непал
марвар: марвар
статьятекущий: статьятекущие
эст: эсте
год: год года годам году
аския: аския
манипур: манипур
саксония: саксония
статьисообществофорумсправкасвежий: статьисообществофорумсправкасвежие
донато: донато
бжегский: бжегское
сэй: сэй
мали: мали
самбалпур: самбалпур
ландмейстер: ландмейстер
мансихж: мансихжи
муромати: муромати
аль: аль
печать: печати
каркия: каркия
чан: чан
бачан: бачан
отто: отто
картлийский: картлийское
хадлирина: хадлирин
политика: политика
чиребон: чиребон
король: король
записьвойти: записьвойти
перевод: переводами
кутб: кутб
сигизмунд: сигизмунд
дополнительный: дополнительные
брауншвейг: брауншвейг
шах: шах
суртан: суртан
бухарский: бухарское
ардо: ардо
гугунгжатить: гугунгжати
христоф: христоф
барнить: барним
республика: республика
наванагар: наванагар
наиль: наиль
франциск: франциск
фонд: фонд
риччард: риччарда
эдцард: эдцард
гуриель: гуриели
рая: раи
поиск: поиск поиску
восточный: восточная восточном
аквамухен: аквамухене
каррар: каррара
страницуполучить: страницуполучить
альбрехт: альбрехт
цзяцзина: цзяцзин
язык: языках
рамазаногуллар: рамазаногуллары
бант: бантам
бенинский: бенинское
баден: баден
лубатко: лубатко
баграт: баграт
исхак: исхак
нарендра: нарендра
джулио: джулио
сайри: сайри
ландграф: ландграф
феррант: ферранте
годскрытый: годскрытая
филиберт: филиберт
ансбах: ансбах
англия: англии англия
любинский: любинское
просмотр: просмотры
феррар: феррара феррары
козимый: козимо
император: император
великодушный: великодушный
таиланд: таиланд
байрет: байрет
ссылкасведение: ссылкасведения
кашмир: кашмир
нгван: нгване
филиппина: филиппины
саи: саи
действовать: действовать
фук: фук
андорра: андорра
отказ: отказ
событияпожертвовать: событияпожертвовать
индонезия: индонезия
мекленбург: мекленбург
цешинский: цешинское
фуа: фуа
алауддин: алауддин
нарапати: нарапати
маад: маад
проверка: проверки
бин: бин
кули: кули
лакхадж: лакхаджи
абдальвадид: абдальвадиды
куинна: куинн
асикага: асикага
померания: померания
османский: османская османский
юсуф: юсуф
эрнест: эрнест
указание: указанием
мантуя: мантуи
нара: нара
маядунн: маядунне
верман: верман
тахмасп: тахмасп
империя: империи империя
фак: фак
трирский: трирское
тэбиншветить: тэбиншвети
викимедиа: викимедиа
мпудить: мпуди
читатьтекущий: читатьтекущая
правка: правок
фр: фр
ахмаднагарский: ахмаднагарский
эсиг: эсиги
свободный: свободной
малёк: малек
хассун: хассун
некоммерческий: некоммерческой
шамарадж: шамараджа
герая: герай
гунунг: гунунг
ахома: ахом
бить: бей
халиф: халиф
чанда: чанд
польша: польша польши
содержание: содержание
рареш: рареш
ваза: ваза
венгрия: венгрии венгрия
домналл: домналл
адам: адам
князькнязь: князькнязь
водить: води
маркграфиня: маркграфиня
вирбхан: вирбхан
масса: масса
литовский: литовский литовское
удать: удай
бухара: бухаре
персональный: персональные
эрих: эрих
сицилия: сицилии
джайнтий: джайнтия
аснаф: аснаф
катманду: катманду
друйминин: друйминин
условие: условий условия
сефевид: сефевиды
кал: кал
джайсалмер: джайсалмер
кальян: кальян
италия: италия
олесницкий: олесницкое
адриаманеть: адриаманело
казанский: казанское
ле: ле
гвидобальдо: гвидобальдо
баракат: баракат
кожура: кожуре
ханство: ханство
аютие: аютия
имеретинский: имеретинское
ди: ди
мёнджон: мёнджон
кимб: кимба
мукмина: мукмин
педро: педро
оттон: оттон
лотарингий: лотарингия
авторство: авторства
юг: юге
сагад: сагад
лункаран: лункаран
пфальц: пфальц
парбат: парбат
хаген: хаген
вальдек: вальдек
правкипостоянный: правкипостоянная
материал: материал
абу: абу
терната: тернате
фон: фон
северный: северная
бхуваньякабах: бхуваньякабаху
каюмарт: каюмарт
фарнез: фарнезе
китай: китай китая
фердинанд: фердинанд
керала: керала
февраль: февраля
отредактировать: отредактирована
харя: хари
маласпин: маласпина
ошибкекак: ошибкекак
фуля: фули
португалия: португалии португалия
иран: иран ирана
салуццо: салуццо
джолоф: джолоф
притвираж: притвираж
глава: глав
мориц: мориц
виджаянагарский: виджаянагарская
савойя: савойя
рёв: рева
герцогство: герцогство
вид: вид
вождь: вождь
иоганн: иоганн
имя: имён
сен: сен
ольденбург: ольденбург
мюнстерберг: мюнстерберг
конго: конго
муджаффар: муджаффар
кастилия: кастилии кастилия
мансур: мансур
чирапрамха: чирапрамха
анга: анг
шахиншах: шахиншах
самарканд: самарканде
ульрих: ульрих
легницкий: легницкий легницкое
махараджадхирадж: махараджадхираджа
малдева: малдев
старый: старый
короткий: короткий
ндонго: ндонго
представиться: представились
могулия: могулия
рата: рату
мая: маи
норвегия: норвегии норвегия
луиджи: луиджи
клавдий: клавдий
адиль: адиль
герцог: герцог
версия: версии версия
наварра: наварра наварры
пьомбино: пьомбино
тоша: тоши
мария: мария
учётный: учётную
сёгун: сёгун
манс: манса
падуспанида: падуспаниды
чосон: чосон
этот: эта
ла: ла
келантан: келантан
альбра: альбре
риджало: риджал
сарипада: сарипада
мвенемутап: мвенемутапа
англ: англ
список: списки список
франц: франц
значительно: значительно
тупак: тупак
йобст: йобст
анна: анна
подробный: подробнее
разработчик: разработчики
знак: знак
имам: имам
мирча: мирча
отдельный: отдельных
мунембира: мунембире
махмуд: махмуд
использование: использования
генуэзский: генуэзская
ямгурчать: ямгурчи
азия: азия
новый: новая
кристиан: кристиан
джафна: джафна
немой: нем
майнцский: майнцское
буганда: буганда
господарь: господарь
вюртембергский: вюртембергский
адо: адо
хафсида: хафсиды
секленмунг: секленмунг
нуньеса: нуньес
ганау: ганау
великолепный: великолепный
мухаммад: мухаммад
ливонский: ливонский
требовать: требуют
великое: великое
георг: георг
ава: ава
джодхпур: джодхпур
багирмить: багирми
бруней: бруней
сцинавский: сцинавское
густав: густав
вольфганг: вольфганг
нгаванг: нгаванг
мина: мин
ибрагим: ибрагим
сеннары: сеннар
кат: кат
иоахим: иоахим
бласко: бласко
атабег: атабег
ситавак: ситавака
кухара: кухар
антонио: антонио
умардин: умардин
русь: руси
сообщить: сообщить
василиевич: васильевич
орчха: орчха
щецин: щецин
дж: джам
медичи: медичи
энрике: энрике
кодистория: кодистория
связаться: свяжитесь
участник: участниками
запольяй: запольяи
тренггана: тренггана
себастьян: себастьян
кайхосро: кайхосро
код: код
махарадж: махараджа
могулистан: могулистан могулистане
вогодый: вогодого
чехия: чехии чехия
гвасталла: гвасталла
страницецитировать: страницецитировать
илья: илья
иоанн: иоанн
рост: ростом
ван: ван
ндиай: ндиае
проверяться: проверялась
хусейн: хусейн
перу: перу
кульмбах: кульмбах
вести: вела
камат: камата
модена: модена модены
статьяобсуждение: статьяобсуждение
королева: королева
кисок: кисоки
япония: японии япония
ещё: ещё
ангальт: ангальт
эфиопия: эфиопия
лансанга: лансанг
маниконго: маниконго
безумный: безумная
княгиня: княгиня
мальдивы: мальдивы
династия: династия
калиньямат: калиньямат
викидать: викиданных
пьер: пьер
урхельский: урхельский
мочь: могут
проверить: проверенной
аппиани: аппиани
русский: русский
бхаратичанда: бхаратичанд
монбельяр: монбельяр
ланнатаять: ланнатай
майсур: майсур
чаирачатират: чаирачатират
эогайн: эогайн
тир: тир
молдавский: молдавское
чхатар: чхатар
гонгма: гонгма
сахиб: сахиб
зайнал: зайнал
массина: массина
килаунжа: килаунжи
добрый: добрый
араккал: араккал
маленький: мал
римский: римская римский римской
бретань: бретань
леон: леон
накибинга: накибинге
ровер: ровере
заглавный: заглавная
нааба: нааба
эрнст: эрнст
поведение: поведения
кук: куки
вильгельм: вильгельм
радж: раджа
епископ: епископ
качари: качари
демак: демак
бунди: бунди
маркграф: маркграф
маккарти: маккарти
монгольский: монгольская
сёгунат: сёгунат
магинданао: магинданао
нилла: нилл
ганеза: ганеза
статистика: статистика
хуан: хуана
мамад: мамаду
княжество: княжества княжество
мехмед: мехмед
вацлав: вацлав
гурийский: гурийское
мвами: мвами
хивинский: хивинское
астраханский: астраханское
область: область
папа: папа
тешинский: тешинское
кабак: кабака
гессен: гессен
священный: священная священной
последний: последний
западный: западной
венецианский: венецианская
зембицкий: зембицкое
джохор: джохор
текст: текст
саиф: саиф
форнари: форнари
нгуйный: нгуен
гулера: гулер
кахетинский: кахетинское
бамум: бамум
заявление: заявление
кано: кано
абдельазиз: абдельазиз
султан: султан
потисарат: потисарат
реджо: реджо
орда: орда
дунгарпур: дунгарпур
тондо: тондо
урбино: урбино
мобильный: мобильная
править: править
нкумбить: нкумби
киа: киа
казахский: казахское
рамдасж: рамдасжи
джатить: джати
бавария: бавария
сюдасвязанный: сюдасвязанные
опытный: опытными
африка: африка
габриел: габриеле
дунама: дунама
кочин: кочин
дудажа: дудажи
руанда: руанда
далее: д
ответственность: ответственности
грузинский: грузинское
алкивиад: алкивиад
сие: сё
фенен: фенену
абдуллатиф: абдуллатиф
стюарт: стюарт
пфальцграф: пфальцграф
кодекс: кодекс
сеттатират: сеттатират
томохитый: томохито
австрия: австрия
свазиленд: свазиленд
инструмент: инструменты
фризий: фризия
сурид: суриды
бхактапур: бхактапур
нирбхая: нирбхай
берарский: берарский
антон: антон
системеобсуждениевкладсоздать: системеобсуждениевкладсоздать
папский: папская
князь: князь
мутапа: мутапа
кантипур: кантипур
сироха: сирохи
абдулазиз: абдулазиз
индия: индия
торелли: торелли
султанат: султанат
регент: регент
лицензия: лицензии
камбоджа: камбоджа
помпонио: помпонио
испания: испания
пространство: пространства
делла: делла
курфюрст: курфюрст
нри: нри
хан: хан
паттаня: паттани
жуан: жуан
махаран: махарана
паша: паша
страницыслужебный: страницыслужебные
арагон: арагон арагона
якопо: якопо
благочестивый: благочестивый
ссылка: ссылки
мьянма: мьянма
зайян: зайян
манди: манди
тибет: тибет
биджапурский: биджапурский
де: де
конфиденциальность: конфиденциальности
флорентийский: флорентийский флорентийское
варма: варма
нешангва: нешангве
малайзия: малайзия
марокко: марокко
смотреть: см
сунана: сунан
замена: замену
джованни: джованни
фифен: фифен
джалавад: джалавад
сула: сулу
гуджаратский: гуджаратский
гонзага: гонзага
екатерина: екатерина
делийский: делийский
юань: юань
дженкантал: дженкантал
ала: ала
яркендский: яркендское
генрих: генрих
варсангали: варсангали
карлос: карлос
бурх: бурха
граф: граф
амбер: амбер
брюггеноэ: брюггеноэ
весь: всея
товарный: товарный
запрос: запросы
чамб: чамба
биканер: биканер
янош: янош
джамиль: джамиль
садашиварайя: садашиварайя
дрангадхра: дрангадхра
мухаммед: мухаммед
нголый: нгола
богатый: богатый
зарегистрировать: зарегистрированный
бхавнагар: бхавнагар
королевство: королевство
голконда: голконда
кафф: каффа
самба: самба
хандешский: хандешский
луарсаб: луарсаб
имерин: имерина
перенаправление: перенаправлений
монако: монако
гафо: гафо
джамшид: джамшид
перак: перак
царство: царство
ан: ан
прана: прана
статьислучайный: статьислучайная
канди: канди
джайпур: джайпур
север: севере
доступный: доступен
мфон: мфон
баттистый: баттиста
курфюршество: курфюршество
рам: рам
ёситэра: ёситэру
диего: диего
организация: организации
сеньор: сеньор
бахман: бахман
рамаданида: рамаданиды
государь: государь
ёсихара: ёсихару
скачать: скачать
пратабгарх: пратабгарх
филипп: филипп
сусухун: сусухун
бий: бий
случай: случаях
гаск: гаска
буба: бубу
орден: орден
иван: иван
леван: леван
оноре: оноре
пока: пока
канкиль: канкили
проект: проектах
великий: великий
чжу: чжу
конна: конн
павел: павел
бак: баках
бурхан: бурхан
сартанжи: сартанжи
оба: оба
графиня: графиня
вюртемберг: вюртемберг
европа: европа
пол: пол
сохранение: сохранением
ахмад: ахмад
текущий: текущая
крымский: крымское
амир: амир
карл: карл
абидин: абидин
ирландия: ирландия
десмонд: десмонд
описание: описание
сонгай: сонгай
бернард: бернард
участие: участие
астана: астана
ноябрь: ноября
другой: других
государство: государств
бидарский: бидарский
эзе: эзе
ваттасида: ваттасиды
паханга: паханг
хайруно: хайрун
овернь: овернь
аргунский: аргунская
валахий: валахия
пири: пири
оман: оман
источник: источник
подебрадович: подебрадович
ратор: ратор
котт: котте
грозный: грозный
леона: леона
нассау: нассау
