организовать: организовал
мы: нами
делегат: делегатов
учредительный: учредительного учредительное
майский: майская
согласиться: согласились согласился
один: одно
кирог: кироги
другой: другие другими других
судебный: судебного судебное
собственный: собственную
начать: начал начали начать
заставить: заставили
поражение: поражение
требовать: требовал требуют требуя
доминго: доминго
вести: вести вёл
использовать: использующие
полномочие: полномочия
возобновить: возобновив возобновил
справиться: справился справиться
поздний: позже
предводительство: предводительством
президент: президент президента президентом
аналогичный: аналогичные
условие: условий условия условиях
заниматься: занималась
захватить: захватил захватила захватили захватить
энциклопедия: энциклопедии
изменение: изменений
стать: став стал стала стали
морской: морскую
сентябрь: сентября
продолжение: продолжению продолжения
битва: битва битве битвы
версияправитьправить: версияправитьправить
правкиновое: правкиновые
привести: привело
создать: создавшим
солано: солано
кампания: кампанию кампания
новый: нового новое новую новые новым новыми
перейти: перейти
отсутствие: отсутствие отсутствием
примечание: примечания
страницасодержаниеизбрать: страницасодержаниеизбранные
современный: современная современной современные современных
стремиться: стремился
иметь: имело
политический: политическое
забытый: забыт
навигация: навигации навигация
медлить: медлил
парагвай: парагвай парагвая
пакт: пакта пакту
гало: гало
угроза: угрозой
франция: франции франция
провинция: провинции провинций провинция провинциями
созвать: созвал созвать
утверждать: утверждал
уругвай: уругвай уругвая
страница: страница страницы
процесс: процесса
осадить: осадил осадили
отличаться: отличаться
возглавить: возглавивший возглавил
унитарист: унитаристами унитаристов унитаристом унитаристы
губернатор: губернатор губернатора губернатором
народ: народами народов
период: период
википедия: википедии википедия
статьятекущий: статьятекущие
год: год года годах году годы лет
потерпеть: потерпел потерпела потерпели
вирасоро: вирасоро
статьисообществофорумсправкасвежий: статьисообществофорумсправкасвежие
диктатор: диктатора
хороший: хороших
принять: принял принята приняты принять
сделать: сделал
провалиться: провалились
печать: печати
заручиться: заручившись заручиться
коста: косты
заменить: заменив
ход: ходе
французский: французских
жена: жена
политика: политика политики
невыясненный: невыясненных
отправить: отправлены
свержение: свержения
исп: исп
закончиться: закончилась
записьвойти: записьвойти
куллен: куллен
герб: герб
дополнительный: дополнительные
возвращение: возвращение
свой: своего
пытаться: пытаясь
медиафайл: медиафайлы
поверить: поверить
большой: большое велики
республика: республика
сармьенто: сармьенто
конституция: конституции конституцию конституция
государство: государства государствами государство государством
набег: набеги набегов
фонд: фонд
качество: качестве
такой: такие
выступать: выступая
назначить: назначен назначил
всё: всё
срок: срока
поиск: поиск поиску
коренной: коренными коренных
исчезнуть: исчезнувшие
страницуполучить: страницуполучить
поддержка: поддержки поддержкой поддержку
эскурра: эскурра
военный: военной военные военный
язык: язык языках
выйти: вышла
оставаться: оставалось оставался
право: права
уркиса: уркиса уркисе уркисой уркису уркисы
отказаться: отказалась отказались отказался
здание: здания
конфедерацияисп: конфедерацияисп
уйти: ушёл
укрепить: укрепило
переворот: переворот
временной: временным
развивать: развивать
север: север севере
просмотр: просмотры
англия: англия
распределение: распределения
аннексировать: аннексирован
разбирательство: разбирательство
ссылкасведение: ссылкасведения
выработка: выработки
представитель: представителями
росас: росас росаса
испанский: испанский испанской
действовать: действовать
дойти: дойдя
война: война войну
внешний: внешние
оба: обе
результат: результате
отказ: отказ
событияпожертвовать: событияпожертвовать
экспорт: экспорта
огромный: огромные
закрепить: закрепить
государствабыть: государствабывшие
закон: законов
проверка: проверки
восхвалять: восхваляя
армия: армию армия
сопротивляться: сопротивлялась сопротивлялся
время: время
конфедерация: конфедерацией конфедерации конфедерацию конфедерация
мочь: мог могли могут
порт: портом
указание: указанием
непризнанный: непризнанные
викисклад: викискладе
мешать: мешала
викимедиа: викимедиа
читатьтекущий: читатьтекущая
свободный: свободной
конфедерациискрыть: конфедерациискрытые
балькарс: балькарсе
внесение: внесением внесении
подавить: подавить
некоммерческий: некоммерческой
ассамблея: ассамблеи ассамблею ассамблея
снять: сняла сняли
позволить: позволило
пас: пас паса
законодательный: законодательная законодательного законодательный
содержание: содержание
страна: страна странами страны
хуан: хуан хуана хуаном
революция: революции революцию революция
федерализация: федерализации федерализацию
флот: флот
портал: портал
соглашение: соглашения
викискладепортал: викискладепортал
персональный: персональные
решить: решили
утерять: утеряны
рио: рио
касероса: касеросе
сочетать: сочетала
действие: действие действия
также: также
территория: территории
месяц: месяц
это: этим это
январь: января
сдержать: сдержать
сопротивление: сопротивление
обеспечить: обеспечить
усилить: усилило
подписание: подписание подписанием
несколько: нескольких несколько
поэтому: поэтому
расширение: расширение
поднять: подняли
авторство: авторства
юг: юге
восстание: восстание
объявление: объявлениями
правкипостоянный: правкипостоянная
материал: материал
посредничество: посредничеством
ориенталес: ориенталес
название: название названий названия
отредактировать: отредактирована
договор: договор договора договором
ошибкекак: ошибкекак
примерно: примерно
выходец: выходец
победа: победы
сношение: сношения
гильермо: гильермо
нападать: нападавших
национальный: национальную
имя: имён
против: против
покинуть: покинуть
отношение: отношении отношений
количество: количество
гаучо: гаучо
правительство: правительство
америкираный: америкиранее
конституционный: конституционную
стремление: стремление
короткий: короткий
настолько: настолько
представиться: представились
присоединиться: присоединились присоединиться
попытаться: попытался
проект: проект проектах проекту
версия: версии версия
бустоса: бустоса
житель: жителями
учётный: учётную
итог: итоге
английский: английских
город: город города городе городу
этот: эта этому
поддержать: поддержал поддержали
включать: включала
монтевидео: монтевидео
факундо: факундо
аргентинский: аргентинская аргентинские аргентинский аргентинской аргентинскую
аргентина: аргентина аргентиной аргентину аргентины
влияние: влияние
блокада: блокада блокаду блокады
столица: столица столицей столицы
наделить: наделив
породить: породило
победить: победил побежден побеждён
землевладелец: землевладельцы
значительно: значительно
конфедеративный: конфедеративная
треть: треть
объединиться: объединились
пленный: пленных
форма: форма
подробный: подробнее
разработчик: разработчики
знак: знак
флаг: флаг
мера: меры
отдельный: отдельных
особенно: особенно
энкарнасьон: энкарнасьон
кордова: кордове
использование: использования
газета: газеты
сам: самого
франсиско: франсиско
раскол: раскол
отделение: отделения
пустыня: пустыне
который: которая которые который которым которых
самый: самым
населённый: населённые
викискладэлемент: викискладэлемент
лига: лигой лигу
однако: однако
свергнуть: сверг свергнут
умереть: умер
сильный: сильным
поддерживать: поддерживал
переименовать: переименована
гимн: гимн
президентский: президентская
доход: доходов
отставка: отставке отставки
считать: считало
антонио: антонио
пинто: пинто
сообщить: сообщить
написание: написания
хосе: хосе
работа: работе
мануэль: мануэль мануэля
законный: законную законным
остановить: остановить
кодистория: кодистория
связаться: свяжитесь
участник: участниками
бартолом: бартоломе
федеральный: федерального федеральный
многий: многих
код: код
власть: властей власти власть
вторжение: вторжению
страницецитировать: страницецитировать
выход: выходе
проверяться: проверялась
перу: перу
ориб: орибе
реставратор: реставратора реставраторов
ривера: риверой
вынудить: вынудив
сумма: суммой
бенавидес: бенавидеса
статьяобсуждение: статьяобсуждение
течение: течение
выгнать: выгнал
колония: колонии
митра: митре
ещё: ещё
беднота: бедноты
спокойствие: спокойствие
основать: основанные
викидать: викиданных
боливия: боливии боливия
поправка: поправки поправок
созыв: созыва
расти: растущую
сторона: стороне
проверить: проверенной
делегировать: делегировать
русский: русский
стр: стр
морить: морено
правление: правление правления
государственный: государственной государственных
конфликт: конфликта конфликте конфликты
мария: марии
заглавный: заглавная
вернуться: вернулись вернулся вернуться вернётся
окончательно: окончательно
ривер: риверы
поведение: поведения
кук: куки
человек: людьми
суметь: сумел
уехать: уехал
случай: случае случаях
ссылка: ссылками ссылки
независимость: независимости независимость
восстать: восставшие
потерять: потерял
статистика: статистика
распоряжаться: распоряжаться
история: истории история
южный: южной
изменить: изменив
обстоятельство: обстоятельствах
француз: французов
тридцать: тридцать
хусто: хусто
конечный: конечном
объявить: объявил объявила объявить
воспользоваться: воспользовались
повреждение: повреждения
последний: последний
возможность: возможность
распространить: распространить
текст: текст
хотеть: хотели
собрание: собрание собрания
заявление: заявление
регион: регион
оно: оно
должный: должен
ст: ст
вера: веру
корабль: кораблей
мобильный: мобильная
фаустино: фаустино
править: править
федералист: федералистов
осуществить: осуществлённое
небольшой: небольшая
суд: суда
выгодный: выгодных
опытный: опытными
сюдасвязанный: сюдасвязанные
являться: являлось
убийство: убийство
ответственность: ответственности
принятие: принятием
парана: парана параны
беспорядок: беспорядки
напасть: напала
взбесить: взбешённый
кодекс: кодекс
протест: протестами
категория: категории
май: мая
инструмент: инструменты
переговоры: переговоры
помешать: помешать
отступить: отступил
восстановить: восстановить
лишь: лишь
начало: начала
трудность: трудностями
системеобсуждениевкладсоздать: системеобсуждениевкладсоздать
дипломат: дипломат
лицензия: лицензии
преследовать: преследовал
пространство: пространства
отвечать: отвечал
несмотря: несмотря
действительность: действительности
предотвратить: предотвратить
обретение: обретения
бразилия: бразилией
напрямую: напрямую
страницыслужебный: страницыслужебные
основный: основного
войско: войска
первый: первую первые
наполнить: наполнен
точка: точках
исторический: историческое
де: де
противостоять: противостоял
конфиденциальность: конфиденциальности
орган: орган
столкновение: столкновениям
унитаристский: унитаристские
смотреть: см
мятеж: мятеж
воевать: воевал
рамон: рамона
аргентиныисторический: аргентиныисторические
доррий: доррего
глава: главы
река: рекам
найти: нашёл
насарио: насарио
годугосударство: годугосударства
октябрь: октября
просить: просить
важный: важным
товарный: товарный
зарегистрировать: зарегистрированный
прозвище: прозвищем
большинство: большинство
предложить: предложила
сепеда: сепеде
казнить: казнил
роль: роль
она: неё
любой: любом
государствоаргентинский: государствоаргентинская
существовать: существовавшие
лавалье: лавалье
употребляться: употреблялось
подписать: подписал
астрада: астрада
статьислучайный: статьислучайная
сомнение: сомнения
три: трёх
купец: купцов
часть: часть частью
столкнуться: столкнулся
возмутить: возмутило
доступный: доступен
приглашать: приглашая
организация: организации
павона: павоне
гражданский: гражданскую
викискладстатья: викискладстатьи
известный: известного
установленный: установленное
попытка: попытки
перенос: перенос
скачать: скачать
провозгласить: провозгласили
лопес: лопеса
таможня: таможню
неправильно: неправильно
начаться: началась
пока: пока
вдоль: вдоль
херонить: херонимо
фактически: фактически
сохранение: сохранением
вьямонт: вьямонте
текущий: текущая
застрелить: застрелен
описание: описание
эксклюзивный: эксклюзивно
понять: понято
правка: правки
вернуть: вернуть
участие: участие участия
дерк: дерки
распасться: распалась
вскоре: вскоре
соединить: соединённые
бежать: бежать
целесообразность: целесообразности
официальный: официальных
пост: посту
торговать: торговать
источник: источник
сантьяго: сантьяго
чили: чили
