войти: войти
перевозить: перевозить
снабжение: снабжении
пехотный: пехотная пехотный
солнце: солнце
год: год года годе году лет
час: час часа часам часов
поэтому: поэтому
сделать: сделал
фраза: фразу
ожесточённый: ожесточённых
смена: смену
генерал: генерал генерала генералов генералы
ответить: ответил
мешетич: мешетич
авторство: авторства
описание: описание
война: война войну войны
материал: материал материалы
отступать: отступали отступать отступающей отступая
тактический: тактическая
внимать: внимал
кирасирский: кирасирская кирасирской
день: день дней дня
записка: записках записки записок
позиция: позиции позицию
фланг: фланг фланга фланге флангом
дивизия: дивизией дивизии дивизия
основательно: основательно
поиск: поиск поиску
ополчение: ополчение
пожар: пожар
внешний: внешние
далёкий: дальше
арьергард: арьергард арьергарда арьергарде
ночь: ночь
инструмент: инструменты
прекратить: прекратить
двигаться: двигается двигаться
страница: страница странице страницу страницы
русский: русская русские русский русским русских русского русской русскую
экау: экау
обращение: обращения
полка: полка полками полки
упираться: упирался упираясь
также: также
наполеон: наполеон наполеона
район: район районе
составлять: составлял
фронт: фронта фронтом
представиться: представились
область: области
вражеский: вражеской
бросить: бросил
опрокинуть: опрокинули опрокинутые
российский: российскую
решение: решение решению
сдерживаться: сдерживались
динение: динение
заботиться: заботился
печить: печил
кавалерия: кавалерией кавалерии кавалерию кавалерия
изменить: изменить
французский: французские французский французским французских французского французской французскую
текст: текст
кодекс: кодекс
осьмо: осьма
копия: копия
июль: июль июля
батальон: батальон батальона
сто: сто
викисклад: викисклад викискладе
следующий: следующий
предстоящий: предстоящего
берег: берега берегах берегов берегом
возможность: возможности возможность
улан: улан
волковыск: волковыск
француз: французам французов французы
отстаивать: отстаивать
медиафайл: медиафайлы
увековечить: увековечена
белор: белор
апрель: апреля
москва: москвы
рига: рига
потеря: потере потери
лесной: лесной
запад: запад
клаузевица: клаузевиц
высота: высот
понять: понять
лично: лично
бельяр: бельяр
скрытый: скрытая
обнаружить: обнаружены
богарнэ: богарнэ
сдерживать: сдерживал
пехота: пехота пехотой пехоту пехоты
говорить: говорят
три: тремя
командующий: командующие командующий
нацелиться: нацелился
превосходство: превосходство
солдат: солдат солдата солдаты
явиться: явился
событие: события
уязвимый: уязвимой
символ: символом
основный: основная основную основными
глинка: глинка
вспоминать: вспоминают
необходимость: необходимости
случай: случаях
дорогобуж: дорогобуж
встречный: встречный
стрелок: стрелков
карта: карта картами карту
свидетельство: свидетельству
тыс: тыс
выслать: выслал
устремиться: устремилось
ранить: ранен
армия: армией армии армий армию армия
левый: левого левом левый
гусарский: гусарский гусарских гусарской
который: которого котором которую который
рейд: рейд
победа: победа победы
занять: занял заняла заняли
удержать: удержать
захватить: захватил
конница: коннице конницей конницы
итог: итог
ресурс: ресурсы
мочь: мог могли могут
тучков: тучков тучкова
нюхать: нюхая
россия: россию россия
статья: статьи статья
прямо: прямо
трудно: трудно
простор: простор
километр: километрах
служебный: служебные
бой: боем бои бой бою боя боями боёв
каре: каре
пленный: пленные пленных
условие: условий условия
версия: версия
неприятельский: неприятельская неприятельских
перекрывать: перекрывая
тыл: тылу
арьергардный: арьергардные арьергардных
строй: строй строя
отвоёвывать: отвоёвывали
известить: известили
витебский: витебской витебском
разрушить: разрушил
франция: франция
принести: принесла
руководство: руководством
генеральный: генеральное генеральному
корпус: корпус корпуса корпусам корпусу
оперативный: оперативный
установить: установленном
стена: стене
плещеница: плещеницы
валутиный: валутина
перейти: перейдя перейти перешло
пех: пех
правый: правый правым
отдых: отдых
добрейка: добрейкой
проделать: проделать
либо: либо
отойти: отошли отошёл
малоярославец: малоярославец
овраг: овраги оврагом
обелиск: обелиск обелиске
болотистый: болотистый
незадолго: незадолго
белоруссия: белоруссии
связаться: свяжитесь
второй: второй
александр: александру
послать: посланы
догадываться: догадывались
ефрон: ефрона
стр: стр
множество: множество
возглавить: возглавил
надпись: надпись
поречье: поречье
сторона: сторон сторонам стороне сторону стороны
нести: неся
отдыхать: отдыхала
местность: местности местность местностью
окружить: окружённая
архивировать: архивировано
наблюдать: наблюдали
иметься: имеется
пиктупена: пиктупене
состав: составе
видимо: видимо
продвижение: продвижение
фонд: фонд
право: правом
греметь: гремела
продолжать: продолжала продолжали
стоять: стоять
отбивать: отбивает отбивали
сражение: сражение сражении сражений сражению сражения
богданович: богданович
способствовать: способствовала
оккупация: оккупация
лучоса: лучоса
граф: граф графа
навигация: навигации навигация
исчезнуть: исчезнет
лес: лес лесом лесу
дельзона: дельзона
лагерь: лагерь
уваров: уварова
богарне: богарне
место: месте место
отряд: отряд
двина: двиной двину двины
отдавать: отдавая
быстро: быстро
план: планы
лабома: лабома
заглавный: заглавная
разбить: разбил
бородино: бородино
вдоль: вдоль
вырывать: вырывала
содержание: содержание
февраль: февраля
лучесоя: лучесой
почва: почву
иметь: имел имели иметь имея
организовать: организовать
код: код
передышка: передышки передышку
рота: роту роты
ядро: ядрами
командование: командование командовании
несколько: несколькими
трёхдневный: трехдневном трёхдневные
островно: островно
сила: сил силами силы
её: её
сказать: сказал
довольно: довольно
поле: поле полях
штаб: штаба штабе
широта: ш
клястица: клястицы
знать: зная
стеснять: стеснявшие
артиллерийский: артиллерийский артиллерийской
этот: эта
вопрос: вопрос
пустить: пустил
преследовать: преследовали преследовать
брюйер: брюйер
одновременно: одновременно
ранний: ранним
напрасный: напрасной
восстановить: восстановлены
свольный: свольна
правка: правки
авангард: авангарда
оставаться: оставались оставаться
отстать: отставшие
замешательство: замешательства
оказаться: оказался
умирать: умирать
артиллерия: артиллерией артиллерии артиллерию артиллерия
звенигород: звенигород
человек: людей человек
суметь: сумели
витебск: витебск витебска витебске витебску
устрашить: устрашили
фронтальный: фронтальных
испытывать: испытывали
оборонительный: оборонительную
войско: войск войска войсками
дело: дело
бешенковичский: бешенковичский
тысяча: тысяч тысячи
польский: польских
поздний: позднее
алфавит: алфавиту
жестоко: жестоко
бесстрашие: бесстрашие
багратион: багратион багратиона багратиону
подполковник: подполковник
руссель: руссель
смоленск: смоленск смоленска смоленске смоленску
узкий: узкой
архивный: архивная
пожертвовать: пожертвовать
кампания: кампания
он: нему нём
молевый: молево
отечественный: отечественная отечественной отечественную
гродно: гродно
коновницын: коновницын коновницына
дрогнуть: дрогнул
создавать: создавать
ст: ст
остермана: остермана
производиться: производились
тот: тому
язык: языках языке
обладать: обладал
некоммерческий: некоммерческой
отрезать: отрезал
весь: весь
планировать: планируя
раздробленность: раздробленность
память: память
упряжка: упряжках
сообщество: сообщество
заявление: заявление
признавать: признаёт
словарь: словари
появление: появлении появления
дальнейший: дальнейшее
ввести: ввёл
ответственность: ответственности
серия: серию
сведение: сведения сведениям
восстановление: восстановлении
сильно: сильно
теснота: тесноты
полок: полков
берёза: березой
персональный: персональные
негодовать: негодуя
задержать: задержать
спрашивать: спрашивают
храбрый: храбрых
завершить: завершит
выбыть: выбыло
отредактировать: отредактирована
завтра: завтра
система: системе
огонь: огонь
численный: численное
ссылка: ссылка ссылки
брокгауз: брокгауза
чашник: чашники
бешенкович: бешенковичи
беспрепятственный: беспрепятственное
конфликт: конфликт
намерение: намерение намерении
западный: западной
нежинский: нежинский
стойкость: стойкости
сообщить: сообщить
затягивать: затягивать
усиленный: усиленный
сверженя: свержень
избранный: избранные
википедия: википедии википедия
писать: пишет
другой: другие другим других другому
решить: решил
рисунок: рисунок
бабинович: бабиновичи
атака: атак атаки атаку
лицензия: лицензии
новый: новую новые новый
натиск: натиск
реализовать: реализовать
малый: малый
вступать: вступая
разъезд: разъезды
смолян: смоляны
стоя: стоя
приказать: приказал
стрелка: стрелки
деревня: деревней деревни
болото: болото
лучёс: лучесу лучесы
обратиться: обратился
состояние: состоянии
дорого: дорого
ещё: ещё
атаковать: атаковали атаковать
оба: обеим
усиление: усиление
дорога: дороге дороги дорогу
дождаться: дождался
сдержать: сдержать
гора: гора
остановиться: остановились остановлюсь
предыстория: предыстория
битва: битвы
примерно: примерно
свой: своём
заставить: заставили
обстоятельство: обстоятельств
кандыба: кандыба
слово: словам словами
обратить: обратить
обход: обход
раненый: раненые
такой: такому
отступить: отступил
осмотреться: осмотреться
команда: команду
марш: марша
неопр: неопр
править: править
впадать: впадающей
взять: взяв
вид: виду
км: км
равный: равные
спаситель: спасителя
действовать: действовать
подробный: подробнее
прийтись: пришлось
эскадрон: эскадрона
убить: убит
следовать: следовавшей
что: чём
ошибка: ошибке
драгунский: драгунский драгунскую
городня: городня
пушка: пушки
наш: наши
приблизиться: приблизились
столкнуться: столкнулись
император: императором
наносить: нанося
жало: жал
век: век
подойти: подойдет подошла подошёл
котляр: котляров
дава: даву
выйти: выйдя
обсуждение: обсуждение
удачно: удачно
кук: куки
перекрыть: перекрыть
стать: ставшую стал
река: рекой реку
приписывать: приписывает
городечный: городечно
стремление: стремлению
исторический: исторические
мюрата: мюрат мюрата мюрату
участие: участие
березин: березина
пользоваться: пользуясь
выстроить: выстроил
убыль: убыли
отбиваться: отбивалась
запись: запись
форум: форум
частный: частными
куст: кустов
согласно: согласно
создать: создать
вязьма: вязьма
имя: имён
лесистый: лесистая лесистой
орудие: орудий
окулов: окулов
ощутимый: ощутимые
сытина: сытина
печать: печати
стиль: стилю
постоянный: постоянная
польша: польшу
противник: противники
архив: архива
разгореться: разгорелся
остерман: остерман
подготовка: подготовки
викидать: викиданных
заряд: заряды
оборона: оборону
сопутствовать: сопутствовал
вечер: вечеру
минск: минск
контратака: контратаки
мезотен: мезотен
она: неё
скрыть: скрыли
пространство: пространства
позади: позади
хотя: хотя
возобновиться: возобновился
оказывать: оказывал
гусар: гусарами
накануне: накануне
представление: представление
знак: знак
конный: конной конную
уйти: ушла
дать: дать
потребный: потребной
вернуться: вернувшись
получить: получить
принять: принял
разбросать: разбросанным
часть: часть
полк: полк
разведка: разведки
товарный: товарный
сюда: сюда
скачать: скачать
яростно: яростно
отсутствие: отсутствия
куковачиный: куковачино
вклад: вклад
убито: убито
барклай: барклай барклая
воспоминание: воспоминаниям
ночью: ночью
сильный: сильный
смолкнуть: смолкли
так: т
сгрудиться: сгрудившейся
целый: целые
совещание: совещания
видеть: видеть
беспорядок: беспорядка
бесшумно: бесшумно
утро: утра
оплачивать: оплачивать
лабиау: лабиау
куковячиный: куковячино
сие: сие
стянуть: стянул
последовать: последовал
успех: успех
культура: культуры
отходить: отходили
гжатск: гжатск
присутствовать: присутствовавший
табак: табак
простреливать: простреливала
повести: повёл
история: истории история
толпа: толпами
слабый: слабый
мера: мере
цитировать: цитировать
находиться: находившиеся находились
полоцк: полоцк полоцка
группа: группа
сабля: саблю
курьер: курьер
ной: ной
ермолов: ермолова
вывести: выведен вывести
командир: командир
продолжаться: продолжался
зарегистрировать: зарегистрированный
политика: политика
проинспектировать: проинспектировать
просмотр: просмотры
рапорт: рапорт
узнать: узнав узнал
романово: романово
участник: участники
рассеять: рассеяли
против: против
развернуть: развёрнутую
отход: отход отходе отходу
резерв: резерв
памятник: памятников
подготовиться: подготовиться
извещение: извещением
прикрываться: прикрывался
доложить: доложено
себя: собой
подпоручик: подпоручик
сентябрь: сентября
поначалу: поначалу
беларусь: беларуси
дивизионный: дивизионный
город: города
ряд: ряды
стойко: стойко
экз: экз
свежий: свежие свежими
смотреть: см
построить: построены
справка: справка
доходить: доходя
пересечь: пересечённой
пропустить: пропущенные
бригада: бригаду бригады
картечь: картечью
мемуары: мемуары
распоряжение: распоряжении
порядок: порядка
элемент: элемент
духовщина: духовщина
читать: читать
прорвать: прорвать
мы: нами
вернуть: вернуть
казачий: казачьими
готовиться: готовилась
лошница: лошница
графа: графу
трудность: трудности
текущий: текущие
ожидать: ожидал ожидать
полностью: полностью
скоро: скоро
военный: военная
сам: самого
гренадерский: гренадерскою
важность: важности
переменить: переменила
партизанский: партизанская
неожиданно: неожиданно
земля: землю
время: время
белсэ: белсэ
вступить: вступившей
около: около
цель: целью
надобный: надобен
отвечать: отвечает
можайск: можайск
вырываться: вырывались
выбор: выбором
оценивать: оценивают
примчаться: примчался
мобильный: мобильная
единый: единое
свод: свод
перемена: перемены
христос: христа
соединиться: соединившись соединиться
пикет: пикет
состоять: состоящие
многочисленный: многочисленные
петруся: петруся
идти: шли
энциклопедия: энциклопедии
дований: дованием
действие: действия
прежде: прежде
деятельность: деятельности
красный: красный
делать: делало делать
застава: заставами
доступный: доступен
мир: мир
ляхово: ляхово
наметить: намеченному
храм: храма
закончить: закончена
источник: источник
именоваться: именуются
бровка: бровки
преследование: преследование
село: села
кавалерийский: кавалерийского
заслон: заслон
верить: верить
должный: должен
категория: категории категория
учётный: учётную
короткий: короткий
остановить: остановить
просто: просто
главное: главного
викимедиа: викимедиа
эпизод: эпизод
палить: палена
достигнуть: достиг
использование: использования
случайный: случайная
главный: главными
больший: большие
тирион: тириона
пока: пока
офицер: офицер
утомлённый: утомленные
отражать: отражали
молодечно: молодечно
салтановка: салтановка
основной: основной
означать: означало
ход: ход
храбрость: храбрость
закрываться: закрываясь
беларускать: беларуская
подтянуть: подтянуть
военачальник: военачальниками
муниципалитет: муниципалитет
едва: едва
отдельный: отдельных
устройство: устройству
остальной: остальное
заставлять: заставляли
отказ: отказ
тарутиный: тарутино
евгений: евгения
проект: проектах
сохранение: сохранением
свободный: свободной
вялый: вялый
указание: указанием
конфиденциальность: конфиденциальности
связанный: связанные
утром: утром
дата: дата
начальник: начальника
сегюр: сегюра
аустерлица: аустерлица
часто: часто
поведение: поведения
двинуться: двинулась
разработчик: разработчики
бегство: бегство
палёный: пален
дополнительный: дополнительные
впечатление: впечатление
прислать: прислал
последний: последний
это: это
сражаться: сражался
наткнуться: наткнулись
примечание: примечания
хорват: хорватов
организация: организации
добрейк: добрейка
передавать: передает
август: августа
гласить: гласит
однако: однако
расстреляться: расстрелялись
кобрин: кобрин
январь: января
крылатый: крылатую
сообщение: сообщение
неприятель: неприятеля
колонна: колоннами
велижатый: велижат
койдан: койданов
вилькомир: вилькомир
статистика: статистика
