войти: войти
этот: эта этому
остаток: остатки
обучение: обучения
отзыв: отзывах отзывы
катер: катер
приём: прием
глубина: глубины
описание: описание
состав: состава
выпустить: выпущен
авторство: авторства
война: войной войну
маркуанда: маркуанд
сцена: сцен сцены
материал: материал
предоставить: предоставил предоставила
уильям: уильям уильяма
выбирать: выбирают
пьяный: пьяным
средиземный: средиземного
фильмография: фильмография
повод: поводу
поиск: поиск поиску
джеймс: джеймс
флот: флот
уилера: уилер
первый: первую
бывший: бывший бывших
инструмент: инструменты
обзор: обзоров обзоры
страница: страница странице страницу страницы
ноябрь: ноябре
значительно: значительно
обращение: обращения
пистолет: пистолета
спецназовец: спецназовцы
домашний: домашнем
представиться: представились
куррана: курран куррана
обнаруживать: обнаруживает обнаруживают
порт: портов порты
фоновый: фоновые
пилот: пилотов
опыт: опыт опыте
режиссёр: режиссером режиссёр
дейн: дейн
жизнь: жизни жизнь
сбивать: сбивает
автор: авторы
оперативный: оперативного
текст: текст
бин: бин
кодекс: кодекс
бюджет: бюджет бюджета
сюжет: сюжет
лишённый: лишенным
варренс: варренс
пройти: прошли
джим: джим
изображать: изображает
испанский: испанская испанский
шум: шума
пляж: пляже
пропагандистский: пропагандистский
реагировать: реагирует
внезапно: внезапно
данна: данн
северный: северной
реалистичный: реалистичная
минировать: минируют
роджер: роджером
эрнест: эрнеста
торг: торгов
резюмироваться: резюмируются
здание: здания
внутри: внутри
помещение: помещение
событие: события
уничтожить: уничтожили
анджело: анджело
плохой: худший
база: базе базу базы
детонация: детонации
ящик: ящиков
взорвать: взорвать
представить: представлена
случай: случаях
ранить: ранен
армия: армию армия
забастовка: забастовки
оператор: оператор
отличаться: отличаться
который: которая которой котором которые который
двухнедельный: двухнедельный
чарли: чарли
штат: штат
статья: статьи статья
скрытый: скрытые
высаживаться: высаживается
тиго: тига
служебный: служебные
лидер: лидера
видеомагазин: видеомагазина
условие: условий условия
версия: версии версия
пулемёт: пулемёта
бтр: бтр
четыре: четырех
оружие: оружием
статистика: статистика
появляться: появляется
проникать: проникает
сценарий: сценарии сценарий сценария
джоан: джоан
лежать: лежат
съёмочный: съемочных
опасение: опасения
перейти: перейти
бейрут: бейрут
сбор: сборы
вертолёт: вертолеты вертолёт
англ: англ
гореть: горящим
привлечь: привлечен привлечены
млн: млн
курс: курс
миллион: миллион миллиона миллионов
действительно: действительно
британский: британском
джарра: джарру
мавританский: мавританского
связаться: свяжитесь
террорист: террористами террористов террористы
уолли: уолли
незавершённый: незавершённые
начаться: начались
фабрика: фабрику
агентство: агентства
дж: дж
критик: критиков
элмор: элмор
следующий: следующим
некоторый: некоторые
переговоры: переговоры
производство: производстве производство
правка: правки правок
отказаться: отказался
перестрелка: перестрелки
один: одного одной одном
архивировать: архивировано
заменять: заменял
мой: моей
негативный: негативные
талант: талант
название: названия
март: марта
фонд: фонд
сообщаться: сообщается
льюис: льюис льюиса
мочь: могут
военный: военный
сайт: сайте
боевой: боевые боевых
навигация: навигации навигация
смерть: смерть
свободный: свободное свободной
санчёс: санчес
год: год года году
пфаррер: пфаррер пфаррером пфарреру
котик: котик котиками котики котиков
танк: танки
берег: берега
хороший: хороший хорошим
осень: осенью
венчур: венчур
заглавный: заглавная
написать: написал написать
рейтинг: рейтинг
устраивать: устраивают
заготовка: заготовка
содержание: содержание
джоанна: джоанн
критика: критика
получить: получил получили получить
код: код
уильямс: уильямс
мина: мин
успех: успех успеха
картахена: картахена картахены
её: её
уэст: уэст
окончание: окончания
телевидение: телевидении
недалеко: недалеко
свой: своей своих свой
отряд: отряда
стингер: стингер
они: ними
команда: команда командах
встретиться: встретились
улица: улиц
одновременно: одновременно
борт: борта борту
преследование: преследованием
продюсер: продюсера продюсеров продюсеры
консультант: консультантов
крупнокалиберный: крупнокалиберного
оказаться: оказался
просыпаться: просыпается
положительный: положительными
фильм: фильм фильма фильмах фильме фильмом фильму фильмы
реквизировать: реквизируют
вирджиния: вирджинии вирджиния
алфавит: алфавиту
арабский: арабские арабских
герой: героев
переписывать: переписывали
заявить: заявленного
русский: русский
пожертвовать: пожертвовать
билл: билл
кинокомпания: кинокомпания
основать: основанный
сексистский: сексистским
номер: номером
захватывать: захватывают
чак: чак чаку
вдохновить: вдохновленный
высмеиваться: высмеивается
язык: язык языках языке
единственный: единственная
работа: работа
клэр: клэр
некоммерческий: некоммерческой
айра: айра
джентльмен: джентльмен
сценарист: сценаристов сценаристы
гнилой: гнилых
вербовка: вербовке
весь: весь
даром: даром
признание: признание
норфолк: норфолк норфолке
съёмка: съемки съёмки
сообщество: сообщество
интеллектуальный: интеллектуальные
заявление: заявление
лодка: лодки лодку
ночь: ночи
агент: агент
май: мая
ответственность: ответственности
неделя: неделю
автомобиль: автомобиль
персональный: персональные
титр: титрах
отредактировать: отредактирована
система: системе
лири: лири
жанр: жанр
курсировать: курсировавшего
приключенческий: приключенческий
проверка: проверки
хотеть: хотел хотели
тот: тех
ссылка: ссылка ссылки
рик: рик
динамичный: динамичные
трюк: трюков
сообщить: сообщить
морской: морская морские морскими морских морское морской
гарь: гари
провалиться: провалились
избранный: избранные
википедия: википедии википедия
бернард: бернард
пиццо: пиццо
огонь: огнём
проверить: проверенной
лицензия: лицензии
райан: райан
следовать: следует
новый: новые новый
призвать: призвал
юг: юг
лётчик: лётчиков
плен: плен
он: нему
ещё: ещё
мерседес: мерседес
рамос: рамос
релиз: релиз
уход: ухода
сделать: сделать
конечный: конечном
ручной: ручной
черновик: черновик
отмечать: отмечает
левать: левай
пол: пол
корт: корт
подводный: подводные
доллар: долларов
вместе: вместе
неприязнь: неприязнь
пехота: пехота
полка: полках
остановить: остановила
нога: ногу
стинсон: стинсон
неопр: неопр
судный: судном
группа: групп группа группе группы
поднять: поднятый
править: править
писать: писал
продолжаться: продолжалось
ищущий: ищущие
кевин: кевину
самый: самые
действовать: действовать действующий
подробный: подробнее
показать: показано показаны
спасение: спасению
ошибка: ошибке
скотт: скотт
иметь: имеет имел
пытаться: пытается
пушка: пушки
сдать: сдал
часовой: часовых
алонсо: алонсо
снять: снять
уоррен: уоррен
случайно: случайно
море: моря
обнаружить: обнаружена
переписать: переписать
выбрать: выбранный
обсуждение: обсуждение
персонаж: персонаж
кук: куки
взволнованно: взволнованно
средиземноморский: средиземноморские средиземноморских
хокинс: хокинс
стампф: стампф
моррис: морриса
джон: джон
участие: участие
испания: испании
семь: семи
боевик: боевик боевиков
сидеть: сидящего
выстрел: выстрела
напарник: напарники
склад: склад
запись: запись
форум: форум
помещать: помещают
переместиться: переместились
замена: замену
наварон: навароне
манёвр: маневрах
создать: создать
имя: имён
главный: главных
пзрк: пзрк
качество: качестве
видео: видео
печать: печати
рональд: рональд
постоянный: постоянная
ход: ходе
страна: страна страны
покров: покровом
подлодка: подлодки подлодкой
город: город
неуказанный: неуказанные
снимать: снимавших
купить: купил
викидать: викиданных
лейтенант: лейтенант
мошенник: мошенников
энди: энди
стать: стал
сша: сша
основное: основном
грэхема: грэхем
пространство: пространства
шина: шин шина
август: августе
джозеф: джозеф
знак: знак
атомный: атомной
ридлить: ридли
часть: часть
тариф: тарифа
колкер: колкер
жарра: жарр
пэкстон: пэкстон
проезжать: проезжавший
продать: продал
линкор: линкоры
товарный: товарный
сюда: сюда
скачать: скачать
писатель: писателей
вклад: вклад
требовать: требуют
намного: намного
гэри: гэри
кассовый: кассового
опытный: опытными
дебютировать: дебютировав
рецензия: рецензии
финальный: финальная финальном
сведение: сведения
видеть: видеть
нанять: нанят наняты
вода: воде
рейлли: рейлли
другой: других
майкл: майкл
английский: английский английском
кассета: кассету
считаться: считался
оригинал: оригиналом
выступить: выступил
эпат: эпата
возрождение: возрождения
граната: гранатой
архитектура: архитектуры
кадис: кадис
счесть: сочтен
фейген: фейген
конец: конце
внутренний: внутренний
июль: июля
прибывать: прибывает
утопить: утопил
клуб: клубов
интервью: интервью
это: этим это
капитан: капитан
цитировать: цитировать
дейл: дейл
билли: билли
технический: технических
диалог: диалога
зарегистрировать: зарегистрированный
выполнение: выполнения
политика: политика
просмотр: просмотры
затем: затем
помочь: помогите
длительность: длительность
сначала: сначала
операция: операции
начальный: начальной
использовать: использовал используя
подрывать: подрывают
сентябрь: сентября
участник: участниками
надеяться: надеясь
укрытие: укрытии
акватория: акватории
добираться: добираются
марк: марк
хранить: хранят
американский: американские американский американских американской
дональдсон: дональдсоном
свежий: свежие
смотреть: см
зависать: зависает
актёр: актеров актеры
тренировка: тренировках
справка: справка
проверяться: проверялась
итог: итоге
элемент: элемент
гражданский: гражданской
полевой: полевых
бренд: бренда
больший: больший
время: времени время
читать: читать
мы: нами
принять: приняв
невыигрышный: невыигрышный
восемь: восемь
текущий: текущая текущие
сниматься: снимались
история: история
кинотеатр: кинотеатрах
мобильный: мобильная
ехать: едут
карлтон: карлтон
понравиться: понравился
быть: будут
сильный: сильным
энциклопедия: энциклопедии
клиент: клиентов
жаловаться: жалуется
произведение: произведения
вообще: вообще
доступный: доступен
шаблон: шаблона
мешанина: мешаниной
охватить: охваченный
голдман: голдман
источник: источник
характер: характера
учётный: учётную
авианосец: авианосца
схватка: схватка
короткий: короткий
дополнить: дополнив
просто: просто
рэндалл: рэндалл
викимедиа: викимедиа
рядом: рядом
сильвестр: сильвестр
уходить: уходят
разочаровать: разочарованы
использование: использования
дым: дыма
случайный: случайная
вероятно: вероятно
пока: пока
убивать: убивает
очень: очень
зимой: зимой
офицер: офицер
старый: старый
категория: категории
звезда: звезды
нападение: нападение
штабель: штабели
эллиот: эллиот
россович: россович
переписывание: переписывание переписывания
страсть: страсть
отдельный: отдельных
выразить: выразил
похмелие: похмелья
тиг: тиг
нравиться: нравится
происходить: происходит
проект: проектах
отказ: отказ
сохранение: сохранением
хэйсберт: хэйсберт
развитие: развитию
указание: указанием
конфиденциальность: конфиденциальности
ливана: ливан
связанный: связанные
утром: утром
роль: ролях
пропадать: пропадают
дата: дата
меркерсон: меркерсон
поведение: поведения
собрать: собрав
клерк: клерках
флойда: флойд
пора: пор
разработчик: разработчики
несколько: несколько
дополнительный: дополнительные
судно: судно
последний: последний
предложить: предложили
примечание: примечания
организация: организации
однако: однако
образ: образом
сирил: сирил
орион: орион
конкретизация: конкретизации
трое: троих
деннис: деннис
январь: января
уничтожать: уничтожают
эвакуироваться: эвакуируются
ричард: ричард
зритель: зрители
хемингуэй: хемингуэя
композитор: композитор
джолен: джолена
