войти: войти
положение: положение положении
начало: начале
описание: описание
авторство: авторства
материал: материал
журнал: журнал
поиск: поиск поиску
автоматический: автоматические автоматического
находиться: находящейся
инструмент: инструменты
механизм: механизм
страница: страница странице страницу страницы
ружьё: ружьё
масса: масса
также: также
советский: советские
кг: кг
тип: тип
представиться: представились
характеристика: характеристикам характеристики
расположить: расположить
честь: честь
положительно: положительно
текст: текст
кодекс: кодекс
копия: копия
магнитола: магнитоле
викисклад: викисклад викискладе
свободный: свободной свободный
возможность: возможность
медиафайл: медиафайлы
звук: звука
скорострельность: скорострельность
спроектировать: спроектирован
низко: низко
затвор: затвор затвора затвором
событие: события
фирма: фирмой
число: числе
случай: случаях
ремень: ремня
сложённый: сложена
заполнить: заполнить
результат: результатам
спереди: спереди
вооружение: вооружение вооружении вооружения
оригинальный: оригинального
статья: статьи статья
установка: установка установки
выставка: выставке
скрытый: скрытые
боевой: боевое боевом
отъёмный: отъёмный
служебный: служебные
свой: своего
бой: боя
условие: условий условия
версия: версия
оружие: оружие оружии оружия
рукоятка: рукоятка рукоятки рукояткой рукоятку
устройство: устройство
перейти: перейти
использоваться: используется
вид: вид виде
либо: либо
белоруссия: белоруссии
связаться: свяжитесь
незавершённый: незавершённые
ведение: ведения
производство: производства производство
фин: фин
один: одной
ось: оси
иметься: имевшиеся имеется
показать: показан
превосходить: превосходят
фонд: фонд
определённый: определённой
отсутствовать: отсутствует
мочь: могут
сайт: сайте
военнослужащий: военнослужащих
навигация: навигации навигация
конструкция: конструкция
иностранный: иностранные
несовпадение: несовпадения
год: год годов году годы
назвать: названный
скорость: скорость
заглавный: заглавная
заготовка: заготовка
содержание: содержание
февраль: февраля
м: м
полусвободный: полусвободным
появиться: появились
код: код
оружейный: оружейным
её: её
финляндия: финляндии финляндия
выполнить: выполнен
замедляться: замедляется
страна: страна стране
этот: эта
кучность: кучности
правка: правки
апс: апс
испытание: испытаний
ппш: ппш
крючок: крючок
разработчик: разработчика разработчики
взведение: взведения
хранение: хранении
алфавит: алфавиту
калибр: калибр
огонь: огня
отход: отход отходом
служащий: служащее
архивный: архивная
русский: русский
пожертвовать: пожертвовать
разработать: разработан
язык: языках
освоить: освоить
использование: использование использования
некоммерческий: некоммерческой
париж: париже
сообщество: сообщество
заявление: заявление
мастер: мастером
май: мая
ответственность: ответственности
возобновить: возобновлено
персональный: персональные
отредактировать: отредактирована
система: систем системам системе
тимарь: тимари
кинофильм: кинофильмах
прицельный: прицельная
ссылка: ссылка ссылки
ствол: ствол ствола стволом
магазин: магазин
сообщить: сообщить
избранный: избранные
википедия: википедии википедия
лицензия: лицензии
который: которого которой
ещё: ещё
складный: складной
принцип: принципы
нерегулируемый: нерегулируемый
позволить: позволило
патент: патента
позволять: позволяет
мм: мм
финский: финские финский финской
возможно: возможно
править: править
армия: армия
компактный: компактные
действовать: действовать
подробный: подробнее
ошибка: ошибке
повернуть: повернуть
обсуждение: обсуждение
кук: куки
счёт: счёт
давать: даёт
снарядить: снаряжённый
участие: участие
ингрэм: ингрэм
пистолетный: пистолетной
выстрел: выстрела
запись: запись
форум: форум
создать: создать
имя: имён
иметь: имеет
печать: печати
патрон: патрон патронов
постоянный: постоянная
сказаться: сказавшись
викидать: викиданных
пространство: пространства
длина: длина
конструктор: конструктор
кроме: кроме
знак: знак
уменьшить: уменьшило
сотрудник: сотрудников
получить: получить
штурмовой: штурмовое
товарный: товарный
сюда: сюда
скачать: скачать
производитель: производитель
вклад: вклад
выпустить: выпущено
сведение: сведения
полиция: полицией
парабеллум: парабеллум
другой: других
открытый: открытый
достаточно: достаточно
коробчатый: коробчатый
отнести: отнести
предложить: предложено предложены
степень: степени
пуля: пули
спусковой: спусковой
цитировать: цитировать
вариант: варианты
складской: складском
зарегистрировать: зарегистрированный
политика: политика
нажатие: нажатии
просмотр: просмотры
линия: линии
служба: службы
помочь: помогите
предлагать: предлагаемые
обозначение: обозначением
глушитель: глушителя
одиночный: одиночного
прицел: прицел
свежий: свежие
смотреть: см
возможный: возможна
справка: справка
новый: новые
работа: работы
элемент: элемент
приклад: приклад
предохранитель: предохранитель предохранителя
читать: читать
мы: нами
текущий: текущие
лцу: лцу
стрельба: стрельбе
пистолет: пистолет пистолеты
история: история
крепление: крепление
замедлить: замедленным
мобильный: мобильная
энциклопедия: энциклопедии
переноска: переноски
доступный: доступен
свойство: свойство
источник: источник
учётный: учётную
завод: завода
подбрасывание: подбрасывание
антабка: антабкой
короткий: короткий
дополнить: дополнив
просто: просто
огнестрельный: огнестрельном
викимедиа: викимедиа
яли: яли
дальность: дальность
изображение: изображение изображениями
случайный: случайная
боепитание: боепитания
очень: очень
категория: категории
снятие: снятия
мвд: мвд
отдельный: отдельных
остановить: остановлено
отказ: отказ
производиться: производился
проект: проектах
сохранение: сохранением
указание: указанием
конфиденциальность: конфиденциальности
связанный: связанные
двигаться: движется
поведение: поведения
несколько: несколько
дополнительный: дополнительные
неполный: неполном
установить: установлено
начальный: начальная
это: это
последний: последний
примечание: примечания
организация: организации
однако: однако
проблема: проблем
принять: принят
статистика: статистика
