воссоединяться: воссоединяется
кинкейд: кинкейд
канал: канале
мы: нами
происходить: происходит
сэм: сэм
хороший: лучшая лучший лучших
жить: живущие живёт жили
том: тома томом
узнать: узнает
семья: семья семьёй
мишель: мишель
дочь: дочь
кэмпбелллиз: кэмпбелллиз
великобританиителесериал: великобританиителесериалы
друг: друг друзей
сезон: сезон сезона сезоне сезонов сезоны
официальный: официальный
пожар: пожара пожаре
лиам: лиам
энциклопедия: энциклопедии
читатьправитьправить: читатьправитьправить
шон: шон
сентябрь: сентября
батлер: батлер
правкиновое: правкиновые
мандип: мандип
ресурс: ресурсы
яна: яной
перейти: перейти
пять: пять
страницасодержаниеизбрать: страницасодержаниеизбранные
сверхчеловеческий: сверхчеловеческие
двойной: двойную
существование: существование существования
рейчел: рейчел
навигация: навигации навигация
октябрь: октябре октября
элемент: элемент
каждый: каждое
страница: страница страницы
разработчик: разработчик разработчики
незадолго: незадолго
ученик: ученик
википедия: википедии википедия
статьятекущий: статьятекущие
год: года году
оканава: оканава
статьисообществофорумсправкасвежий: статьисообществофорумсправкасвежие
флайшманна: флайшманн
тиджей: тиджей тиджея
единственный: единственными
маргед: маргед
канада: канаду
дуля: дули
одержимый: одержима одержимая
великобритания: великобритании великобритания
полуволк: полуволк полуволка полуволками полуволки
печать: печати
стать: стала стать
локвуд: локвуд
политика: политика
уезд: уездом
кошмар: кошмар
алан: алан
локвудкедар: локвудкедар
записьвойти: записьвойти
дополнительный: дополнительные
конец: конце
тематический: тематические
сайт: сайт сайте сайты
который: которого которой которые который
помимо: помимо
хепкина: хепкин
керита: керит
фонд: фонд
джина: джина
показать: показан
любовь: любви
доктор: доктор
поиск: поиск поиску
сгореть: сгорела
периодический: периодические
страницуполучить: страницуполучить
язык: языках языки
сущность: сущность
сестра: сестру
узнавать: узнаёт
флинн: флинн
находиться: находится
март: марта
просмотр: просмотры
волк: волка
алекс: алекс
ссылкасведение: ссылкасведения
английскийваллийский: английскийваллийский
наом: наом
действовать: действовать
внешний: внешние
отказ: отказ
аллан: аллан
трансляция: трансляция
событияпожертвовать: событияпожертвовать
ходить: ходящая
британский: британский британского
школа: школе
указание: указанием
роль: роль ролях
настоящий: настоящая настоящее
вд: вд
викимедиа: викимедиа
свободный: свободной
формат: формат
раскрытие: раскрытия
вудс: вудс
случайно: случайно
некоммерческий: некоммерческой
огонь: огне
продюсер: продюсеры
келли: келли
стоунибридж: стоунибридж
производство: производство
джеффрис: джеффрис
содержание: содержание
страна: страна
телеканал: телеканал телеканалов
премьера: премьера
эмилий: эмилию
кронкспенсер: кронкспенсер
кара: кара
встречаться: встречается
запустить: запущенные
джонатан: джонатан
тема: тема
персональный: персональные
свой: своей
дистрибьютор: дистрибьюторы
условие: условий условия
дин: дин
действие: действие
территория: территории
первый: первая первой первый
превращаться: превращаются
маркус: маркус
смит: смит
авторство: авторства
её: её
правкипостоянный: правкипостоянная
материал: материал
спасти: спасти
февраль: февраля
отредактировать: отредактирована
полнолуние: полнолуние
ботсвейн: ботсвейн
фэнтезифантастический: фэнтезифантастические
ошибкекак: ошибкекак
превратиться: превратилось
сеголия: сеголия
габриэлла: габриэлла
сидней: сидней
имя: имён
вогать: воган
скрывать: скрывают скрывая
становиться: становится
короткий: короткий
матеть: матеем
представиться: представились
лонсдейл: лонсдейл
оригинальный: оригинальная
ридиана: ридиан ридиана ридиану
гейл: гейл
учётный: учётную
этот: эта
лес: лесу
дикий: дикие дикий дикой
признаваться: признаётся
англ: англ
подробный: подробнее
угроза: угрозы
пейн: пейн
лиза: лиза
аран: аран
знак: знак
отдельный: отдельными отдельных
использование: использования
катрина: катрина
стая: стае стаи стаями
телесериал: телесериал телесериалы
школепрограмма: школепрограммы
энди: энди
моррис: моррис
корпорация: корпорации
вместе: вместе
однако: однако
создатель: создатель
летти: летти
список: список
ян: яна яны
фэнтезиподростковый: фэнтезиподростковая
ребекка: ребекка
апрель: апреля
сообщить: сообщить
гарви: гарви
серия: серии серий серия
длина: длина
суиня: суини
кодистория: кодистория
связаться: свяжитесь
анять: айми
эмма: эмма
код: код
страницецитировать: страницецитировать
способность: способности
человек: людей человек
оборотняхтелесериал: оборотняхтелесериалы
персонаж: персонажи
уайтвуд: уайтвуд
алфавитутелесериал: алфавитутелесериалы
кей: кей
доказать: доказать
джек: джек
жаклин: жаклин
статьяобсуждение: статьяобсуждение
кейт: кейт
студия: студии
помогать: помогавший
ещё: ещё
годутелесериал: годутелесериалы
мадлен: мадлен
выйти: вышел вышло
исполнительный: исполнительные
викидать: викиданных
мочь: могут
русский: русский
пытаться: пытается
вынудить: вынуждены
английский: английском
фоз: фоз
авервуд: авервуд
жанр: жанре жанры
род: рода
заглавный: заглавная
цивилизованный: цивилизованных
поведение: поведения
кук: куки
тёрнер: тёрнер
шорелла: шорелл
великобританиидраматический: великобританиидраматические
идея: идеей
маленький: маленьком
матея: матей
прийтись: пришлось
прошлый: прошлом
статистика: статистика
виктория: виктория
трансформация: трансформации
новый: новый
вейд: вейд
зверь: звере зверя
число: число
последний: последний последняя
основной: основные
текст: текст
встретить: встретивший
воэновый: воэнов
фэнтези: фэнтези
касса: касса
прайс: прайс
кровь: кровь
заявление: заявление
мобильный: мобильная
править: править
держаться: держаться
сюдасвязанный: сюдасвязанные
немецкий: немецкого
ручной: ручной ручным
ответственность: ответственности
главный: главных
среди: среди
полуволков: полуволков
синопсис: синопсис
кодекс: кодекс
версия: версия
российский: российском
кедар: кедар
категория: категории
май: мая
бобби: бобби
появляться: появляется
столетие: столетиями
являться: являются
вожак: вожака вожаком
инструмент: инструменты
мать: мать
алланджонатан: алланджонатан
верстигнуть: верстиг
родитель: родители
волчий: волчья
системеобсуждениевкладсоздать: системеобсуждениевкладсоздать
марк: марк
керь: кери
совместный: совместное
глава: глава
актёрский: актёрский
школьник: школьников
лицензия: лицензии
сериал: сериала
переехать: переехавший
тэйт: тэйт
пространство: пространства
изображение: изображения
стить: стил
дейсия: дейсия
луи: луи
страницыслужебный: страницыслужебные
ник: ник
ссылка: ссылки
мейнир: мейнир
алрик: алрик
удаться: удалось
волков: волков
подростковый: подростковый
конфиденциальность: конфиденциальности
луиза: луиза
боун: боун
смотреть: см
вести: ведут
состав: состав
эмилия: эмилия
гарри: гарри
имара: имара
товарный: товарный
зарегистрировать: зарегистрированный
уолфман: уолфман
завершить: завершённые
называть: называли
дэниэл: дэниэл
раджетта: раджетт
тиджи: тиджи
он: нём
подруга: подруга
распознавать: распознаёт
эффи: эффи
рэглан: рэглан
статьислучайный: статьислучайная
композитор: композитор
жизнь: жизнь
отъезд: отъездом
доступный: доступен
минута: минут
организация: организации
диллоно: диллон
драма: драма драмы
городок: городке
грин: грин
скачать: скачать
начальный: начальная
мэдди: мэдди
случай: случаях
пройти: прошла
актёр: актёр
шеннон: шеннон
начинать: начиная
келлибобби: келлибобби
проект: проектах
уехать: уехать
учитель: учителей
волковангл: волковангл
телесериалытелесериал: телесериалытелесериалы
сохранение: сохранением
мун: мун
описание: описание
участие: участие
ноябрь: ноября
другой: других
уверенный: уверенной
анжел: анжела
усыновить: усыновила
джий: джими
финал: финала
дебби: дебби
существовать: существуют
языкедетский: языкедетские
источник: источник
собственный: собственные
секрет: секрета
тим: тим
леона: леона
