войти: войти
друг: другом
число: числе число
свой: своем своему своё своём
начало: начале
вместо: вместо
поэтому: поэтому
персонал: персонал персонала
количество: количество
авторство: авторства
описание: описание
необходимо: необходимо
федеральный: федеральный
материал: материал
обслуживать: обслуживает
самообслуживание: самообслуживания
автоматически: автоматически
фут: футов
сиэтл: сиэтл сиэтла сиэтле
спиртной: спиртных
использоваться: используются
поиск: поиск поиску
покупка: покупки покупок
всё: всё
бывший: бывший
размер: размером
инструмент: инструменты
угроза: угрозой
страница: страница странице страницу страницы
помещать: помещает
вендинга: вендинге
обращение: обращения
фрукт: фрукты
также: также
открыть: открыл открыт открыть
район: районе
тип: тип
розница: розницу
представиться: представились
безоса: безоса безосу
современный: современные
приобретать: приобретать
распространённость: распространенности
склад: складе
ноябрь: ноября
геолокация: геолокации
товар: товар товара товаров товары
изменить: изменить
текст: текст
кодекс: кодекс
предприятие: предприятия
копия: копия
невозможный: невозможна
магазин: магазин магазина магазинах магазине магазинов магазины
калифорния: калифорния
идея: идее идеи идея
стив: стив
касса: касс кассах кассе кассы
популярность: популярности
викисклад: викисклад викискладе
использование: использованием использования
избавиться: избавилась избавиться
удаляться: удаляется
следующий: следующий следующих
указать: указан
именно: именно
медиафайл: медиафайлы
рбк: рбк
экономика: экономики
камера: камер
апрель: апреля
проприетарный: проприетарная
торговля: торговли торговля
использовать: использующие
потолок: потолке потолки
сколько: сколько
понять: понять
бизнес: бизнеса
паблишер: паблишер
компания: компании компания
крупный: крупный
назвать: назвали названная
оно: оно
добавлять: добавлять
шаар: шаар
команда: командой
деньга: деньги
безналичный: безналичные
событие: события
предел: пределами
первый: первого первое первый первыми
набор: наборы
случай: случае случаях
наличные: наличными
клиент: клиента клиентами клиентов
протестировать: протестированы
американский: американская американский
который: котором которые которых
учёт: учётом
купить: купить
виртуальный: виртуальной виртуальную
продавец: продавца продавцов продавцы
добротный: добротные добротных
реализовать: реализована
штат: штат штатах
статья: статьи статья
опровергнуть: опровергли
скрытый: скрытые
доход: доходом
служебный: служебные
международный: международный
условие: условий условия
версия: версия
шеннон: шеннон
март: март марта марте
считать: считает считают
г: г
квадратный: квадратных
низкий: низким
план: планах
европейский: европейской
приобретение: приобретения
перейти: перейти
холм: холма
англ: англ
автоматизированный: автоматизированная автоматизированный автоматизированными
принцип: принципов
связаться: свяжитесь
некоторый: некоторые некоторых
множество: множество
миллион: миллионы
разработка: разработки
технология: технологией технологии
течение: течение
архивировать: архивировано
заключаться: заключалась
собственный: собственной собственные
мир: мир мира мире
фонд: фонд
вход: входа входе
установить: установить установлены
мочь: могут
навигация: навигации навигация
полка: полках полки полку
самый: самый
год: год года году годы лет
станция: станция
октябрь: октябре октябрю октября
заглавный: заглавная
волшебный: волшебные
выпечка: выпечку
содержание: содержание
февраль: февраля
определить: определить
критика: критика
появиться: появились
код: код
видеокамера: видеокамеры
учётный: учётной учётную учётных
публика: публики
ответ: ответ
задолго: задолго
её: её
ограниченный: ограниченный
агентство: агентство
опубликовать: опубликованному
безос: безос
этот: эта
ведомость: ведомости
оптимизация: оптимизации
одновременно: одновременно
запуск: запуске
капитолийский: капитолийского
правка: правки
основать: основанная основанные
сми: сми
проблематичный: проблематичным
революционный: революционная
расположить: расположен
каждый: каждое
основание: основание
человек: людей человек
демченко: демченко
покупатель: покупатели покупатель покупателя
комиссар: комиссар
спроектировать: спроектировать
формат: формате
алфавит: алфавиту
информация: информации
внутренний: внутренних
данные: данным данных
сотрудник: сотрудники сотрудников
концептуализировать: концептуализированы
архивный: архивная
русский: русский
образ: образов образом
пожертвовать: пожертвовать
компьютерный: компьютерное
сканер: сканер сканером
забрать: забрал
язык: язык языках
место: мест место
работа: работа работы
позволять: позволяет позволяющие
некоммерческий: некоммерческой
система: система системе
датчик: датчиками датчики датчиков
письмо: письма письме
расширение: расширение
сообщество: сообщество
заявление: заявление
май: мае мая
ответственность: ответственности
сеть: сетей сеть
обычный: обычных
персональный: персональные
вашингтон: вашингтон
угловой: угловой
литература: литература
отредактировать: отредактирована
оплата: оплата оплаты
возможный: возможную
корзина: корзину корзины
работать: работают
существовать: существуют
соответствие: соответствии
сложно: сложно
такой: таким
альбина: альбина
ссылка: ссылка ссылки
рассказать: рассказал рассказать
многие: многие
больший: большую
тасс: тасс
ассортимент: ассортимент
один: одна одним одного
сообщить: сообщил сообщить
избранный: избранные
иллинойс: иллинойс
википедия: википедии википедия
фиктивный: фиктивный
джефф: джефф джеффу
нюанс: нюансов
лицензия: лицензии
акционер: акционерам
называть: называют
русскоязычный: русскоязычного
новый: новые новый
изображение: изображении
подразделение: подразделения
турникет: турникеты
ещё: ещё
думать: думали
пополнять: пополняют
насчитываться: насчитывается
фотогалерея: фотогалерея
пер: пер
стать: статей
документ: документах
продуктовый: продуктовый
ошибка: ошибке ошибки
разработать: разработать
аргумент: аргументы
рабочий: рабочее рабочий рабочих
столица: столица
открытие: открытии открытия
отношение: отношении
охранник: охранников
неопр: неопр
править: править
обзор: обзор
запись: записей запись записью
действовать: действовать
подробный: подробнее
декабрь: декабря
прийтись: пришлось
счастливый: счастлив
анатолий: анатолий
кассир: кассиров кассиры
заявить: заявив заявила
мур: мур
исправить: исправить
рассматриваться: рассматривается
работник: работников
обсуждение: обсуждение
кук: куки
конец: конце концов
счёт: счёт
филадельфия: филадельфии
открыться: открылся открыться
участие: участие
брать: берет
написать: написал написала написало
напиток: напитков
обслуживающий: обслуживающий
форум: форум
потерять: потеряют
согласно: согласно
запрещать: запрещающий
пробивать: пробивая
создать: создала создать
интерьер: интерьер
имя: имён
начинать: начинает
связываться: связывается
представитель: представители
вес: веса весов
иметь: имеет
видео: видео
печать: печати
отслеживать: отслеживающей
постоянный: постоянная
автоматизировать: автоматизированы автоматизировать
основатель: основатели основателю
пользователь: пользователей пользователям
город: город городе
викидать: викиданных
раздел: раздела
ответить: ответить
закон: закон закона
история: историю история
сша: сша
пространство: пространства
насчитывать: насчитывает
наличие: наличия
дискриминация: дискриминацию
самостоятельно: самостоятельно
концепция: концепция
частично: частично
знак: знак
лупа: луп
девятый: девятый
смартфон: смартфонов
конкретный: конкретных
получить: получить
часть: часть
сценарий: сценарию
товарный: товарный
сюда: сюда
скачать: скачать
адаптировать: адаптирована
вклад: вклад
сайт: сайт
продукт: продуктами продуктов продукты
консультант: консультанты
включая: включая
принимать: принимают
ранний: ранние
материнский: материнская
смартофон: смартофона
открытый: открытых
сведение: сведения
супермаркет: супермаркет супермаркетами
возможность: возможности возможностью
другой: другая других
приложение: приложение приложения
итого: итого
какой: какие
насколько: насколько
вопрос: вопросы
десять: десяти
июнь: июня
вкалывать: вкалывают
изучаться: изучается
русый: рус
автоматизация: автоматизации
арендовать: арендованном
июль: июля
увидеть: увидеть
являться: является
питер: питер
пробивание: пробивания
списать: списаны
построить: построили
офис: офисах
реализация: реализацией
цитировать: цитировать
площадь: площадью
несовместимый: несовместимым
защита: защите
зарегистрировать: зарегистрированный
политика: политика политикой
запас: запасы
явный: явной
чикаго: чикаго
рекламный: рекламному
просмотр: просмотры
местоположение: местоположение
оплатить: оплатить
нужно: нужно
факт: факты
отсутствовать: отсутствуют
сентябрь: сентябре сентябрь сентября
наталья: наталья
позиция: позиций
свежий: свежие
смотреть: см
соединить: соединенных
проект: проект проектах
справка: справка
элемент: элемент
движение: движения
умный: умных
невозможно: невозможно
координата: координат
читать: читать
указанный: указанных
мы: нами
процесс: процесса
пробить: пробить
предложение: предложений
текущий: текущие
андерсон: андерсон
профсоюз: профсоюз
карточка: карточки
семья: семьи
время: время
состояние: состоянию
пищевой: пищевой
мобильный: мобильная
содержаться: содержащихся
энциклопедия: энциклопедии
прежде: прежде
доступный: доступен
столько: столько
отчёт: отчете
розничный: розничных
упоминание: упоминания
специальный: специальные
источник: источник
должный: должен
платить: платить
промышленность: промышленности
сенсор: сенсоры
короткий: короткий
викимедиа: викимедиа
еда: еды
случайный: случайная
очередь: очередей
касянчук: касянчук
модель: модель
три: трёх
категория: категории
встречать: встречают
основной: основной
иметься: имеются
законодательство: законодательством
распознавание: распознавание
рост: роста
отдельный: отдельных
добавить: добавлен
отказ: отказ
наличный: наличные
происходить: происходит
бейкер: бейкер
обратно: обратно
свободный: свободной
сохранение: сохранением
планировать: планировал
указание: указанием
конфиденциальность: конфиденциальности
расположение: расположение
управляемый: управляемая
связанный: связанные
дата: дата
руководитель: руководителей
поведение: поведения
географический: географических
помощь: помощи
отрасль: отрасль
разработчик: разработчики
почтовый: почтовая
дополнительный: дополнительные
собираться: собираются
власов: власов
робот: роботы
входить: входит
это: это
день: день
последний: последний
немой: нем
дать: данные
примечание: примечания
аналогичный: аналогичным
организация: организации
совершать: совершать
август: августа
январь: января
проблема: проблем
сообщение: сообщение
объединить: объединённый
принять: принят
свобода: свободе
статистика: статистика
