войти: войти
кузьминка: кузьминка
положение: положение
ахун: ахун
татарча: татарча
статистический: статистический
описание: описание
авторство: авторства
материал: материал
всероссийский: всероссийская
стан: стана
карбаш: карбаш
поиск: поиск поиску
инструмент: инструменты
уезд: уезда
шланлыкулевый: шланлыкулево
страница: страница странице страницу страницы
кузеева: кузеева
уездный: уездного
район: район района районе районов
значительно: значительно
восточный: восточное
единый: единый
кузеевский: кузеевский кузеевского
байраш: байраш
населить: населенных населённом населённый населённым населённых
тип: тип
представиться: представились
урал: урал
текст: текст
кодекс: кодекс
заготскот: заготскота
буздяк: буздяк
каранай: каранай
генеалогия: генеалогия
идяшбаш: идяшбаш
спб: спб
использовать: использующие
арсланово: арсланово
россия: россии россия
событие: события
пункт: пункт пунктам пунктах пункте пункты
сост: сост
случай: случаях
село: селе село
карта: карт картами карты
отличаться: отличаться
статья: статьи статья
скрытый: скрытые
водяной: водяные
население: население населения
служебный: служебные
октмый: октмо
условие: условий условия
версия: версии версия
индекс: индекс
мечеть: мечеть
башкир: башкиры
уфа: уфа
устройство: устройство
бийка: биек
перейти: перейти
идентификатор: идентификаторы
белый: белая
белебей: белебея
связаться: свяжитесь
незавершённый: незавершённые
килимовый: килимово
викидать: викиданные викиданных
хабир: хабиров
севадыбашево: севадыбашево
электронный: электронный
хозяйство: хозяйства
фонд: фонд
каран: каран
кыргызча: кыргызча
богад: богады
шарбаш: шарбаш
мочь: могут
навигация: навигации навигация
состав: состав
отделение: отделения
портал: портале
уртакульский: уртакульского
каранбаш: каранбаш
перепись: переписи перепись
кискакулбаш: кискакулбаш
заглавный: заглавная
волшебный: волшебные
губерния: губернии губерния
заготовка: заготовка
содержание: содержание
февраль: февраля
бирск: бирск
туктаркуль: туктаркуль
буздякский: буздякский буздякского буздякском
иштиряк: иштиряк
урановый: ураново
код: код
близкий: ближайшей
комитет: комитет
её: её
широта: ш
заниматься: занимались
значение: значения
киязибаш: киязибаш
михайловка: михайловка
конфессия: конфессии
архангельский: архангельский
завод: завод
этот: эта
становой: становой
список: списке списки список
правка: правка правки
владимировка: владимировка
источник: источник источниками
нижний: нижняя
сыртлановый: сыртланово
клятаяк: клятаяк
новотавларово: новотавларово
татарин: татары
год: года году
алфавит: алфавиту
численность: численность
урзайбаш: урзайбаш
комсомол: комсомол
внутренний: внутренних
федерация: федерации
старотавларово: старотавларово
русский: русский
кубяка: кубяк
пожертвовать: пожертвовать
ислам: ислам
старый: старые старый
язык: язык языках
некоммерческий: некоммерческой
зверинский: зверинским
империя: империи
сообщество: сообщество
заявление: заявление
володарский: володарское
май: мая
ответственность: ответственности
сведение: сведения сведениям
анновка: анновка
персональный: персональные
единица: единица
уфимский: уфимская уфимской
отредактировать: отредактирована
литература: литература
географический: географическое
география: география
система: системе
вып: вып
существовать: существуют
проверка: проверки
место: мест
ссылка: ссылка ссылки
просёлочный: просёлочной
населённый: населённые
нп: нп
сельсовет: сельсовет сельсовета
сообщить: сообщить
субъект: субъект
пояс: пояс
избранный: избранные
википедия: википедии википедия
гкгна: гкгн
проверить: проверенной
текущий: текущая текущем текущие
лицензия: лицензии
новый: новые новый
никольский: никольское
ещё: ещё
ташлыкуль: ташлыкуль
женщина: женщин
верста: верстах
цифровой: цифровые
хазиман: хазиман
больший: большая
шигай: шигай
справочник: справочник
вознесёнок: вознесенка
гафурить: гафури
править: править
башкирский: башкирский
сергеевка: сергеевка
км: км
действовать: действовать
подробный: подробнее
ошибка: ошибке
часовой: часовой
белебеевский: белебеевского
двор: дворах
ата: ате
статус: статус
совет: совет
обсуждение: обсуждение
кук: куки
муниципальный: муниципальный муниципальных
шаран: шаран
последний: последний последняя
мельница: мельницы
участие: участие
дорога: дороге
номер: номер
квартира: квартиры
ишменевый: ишменево
река: река
запись: запись
форум: форум
министерство: министерства
согласно: согласно
национальность: национальности
создать: создать
нохчийна: нохчийн
имя: имён
печать: печати
постоянный: постоянная
обработать: обработан
страна: страна
уртакуль: уртакуль
сабаево: сабаево
юлдузел: юлдузлы
издать: изданном
образование: образований
пространство: пространства
знак: знак
термин: термина
поселение: поселение
получить: получить
республика: республики
новоактау: новоактау
товарный: товарный
сюда: сюда
скачать: скачать
речка: речке
вклад: вклад
требовать: требуют
сабанаево: сабанаево
пчеловодство: пчеловодством
опытный: опытными
жить: жили
дореф: дореф
другой: другие других
новокилимовый: новокилимово
русый: рус
деревня: деревне деревня
редактор: редактором
житель: жители
чатр: чатра
центральный: центральный
цитировать: цитировать
ялтыркулбаш: ялтыркулбаш
зарегистрировать: зарегистрированный
политика: политика
окато: окато
просмотр: просмотры
рассвет: рассвет
мужчина: мужчин
помочь: помогите
чулпан: чулпан
центр: центр центра
баш: баш
таллыкулевый: таллыкулево
участник: участниками
город: города
дело: дел
экз: экз
бакча: бакча
смотреть: см
свежий: свежие
справка: справка
проверяться: проверялась
москва: москва
элемент: элемент
районный: районного районный
религия: религия
шигайкулбаш: шигайкулбаш
читать: читать
мы: нами
указать: указано
тугаево: тугаево
история: история
ярд: ярдам
чишма: чишма
располагаться: располагалась
мобильный: мобильная
энциклопедия: энциклопедии
картамак: картамак
доступный: доступен
свойство: свойство
почтовый: почтовый
башкортостан: башкортостан
человек: человека
учётный: учётную
сарайгировский: сарайгировского
короткий: короткий
дополнить: дополнив
староактау: староактау
викимедиа: викимедиа
амировый: амирово
упомянуть: упомянут
использование: использования
случайный: случайная
совхоз: совхоза
пока: пока
категория: категории
каразирек: каразирек
якуповый: якупово
сельский: сельское
национальный: национальный
устюб: устюба
отдельный: отдельных
отказ: отказ
юрактау: юрактау
проект: проектах
расстояние: расстояние
сохранение: сохранением
свободный: свободной
указание: указанием
конфиденциальность: конфиденциальности
официальный: официальный
станция: станции
архив: архивы
связанный: связанные
поведение: поведения
разработчик: разработчики
дополнительный: дополнительные
изображение: изображений
это: это
усмановский: усмановский
примечание: примечания
организация: организации
российский: российской
письмянтамак: письмянтамак
тюрюш: тюрюше
кузеево: кузеево
преобладать: преобладающие
статистика: статистика
тюрюшевый: тюрюшево
