мы: нами
водный: водного водное
белоус: белоусов
степанов: степанов степанова
ред: ред
факультет: факультета факультеты
оао: оао
использовать: использующие
земский: земского
степеникавалер: степеникавалеры
деятельный: деятельном
значительный: значительный
недоступный: недоступная
статья: статьи
награда: награды
энциклопедия: энциклопедии энциклопедия
читатьправитьправить: читатьправитьправить
вуз: вуза вузов
окончание: окончания
спб: спб
правкиновое: правкиновые
алфавитуродившийся: алфавитуродившиеся
подготовительный: подготовительное
кафедра: кафедра кафедре кафедрой
хозяйство: хозяйства хозяйство
перейти: перейти
ряд: рядов ряды
подвиг: подвиг
академиипреподаватель: академиипреподаватели
примечание: примечания
страницасодержаниеизбрать: страницасодержаниеизбранные
академиивоенный: академиивоенные
навигация: навигации навигация
элемент: элемент
руководство: руководством
страница: страница страницы
преподаватель: преподавателей преподавателем
википедия: википедии википедия
российский: российский
статьятекущий: статьятекущие
год: года году годы лет
сельский: сельского
статьисообществофорумсправкасвежий: статьисообществофорумсправкасвежие
трудовой: трудового
январяродившийся: январяродившиеся
областьроссия: областьроссия
родиться: родившиеся родился
печать: печати
средний: средней
политика: политика
записьвойти: записьвойти
ректор: ректор
дополнительный: дополнительные
отечественный: отечественной
фонд: фонд
музей: музей музея
ркк: ркка
открыть: открыты
поиск: поиск поиску
страницуполучить: страницуполучить
язык: языках
великий: великой
сооружение: сооружений
народ: народа
ссылка: ссылка ссылки
звание: звание звания
учёный: учёное учёные учёный
март: марта
гидравлика: гидравлика гидравлики
г: г
просмотр: просмотры
годуперсоналия: годуперсоналии
экономика: экономики
ссылкасведение: ссылкасведения
новочеркасскеумереть: новочеркасскеумершие
алфавитувыпускник: алфавитувыпускники
специальность: специальности
исследование: исследования исследованиях
действовать: действовать
отказ: отказ
событияпожертвовать: событияпожертвовать
победа: победу
россия: россия
инженерный: инженерная инженерного инженерных
школа: школе
старший: старшим
указание: указанием
мелиоративный: мелиоративная мелиоративного мелиоративной мелиоративных
викимедиа: викимедиа
свободный: свободной
волшебный: волшебные
научный: научная научных
знаменинаграждить: знаменинаграждённые
некоммерческий: некоммерческой
кадр: кадров
знамя: знамени
журнал: журнал
содержание: содержание
страна: страна
армия: армии
персональный: персональные
гидротехнический: гидротехнических
участвовать: участвовал
война: войне войны
условие: условий условия
новый: новые
академик: академик
январь: января
авторство: авторства
правкипостоянный: правкипостоянная
дата: дата
материал: материал
рсфср: рсфср
отредактировать: отредактирована
ошибкекак: ошибкекак
добавить: добавить
государственный: государственная государственной
имя: имён
архивировать: архивировано
литература: литература
август: августа
сельскохозяйственный: сельскохозяйственного
короткий: короткий
представиться: представились
профессор: профессор профессором
область: области область
учиться: учился
учётный: учётную
инициатор: инициатором
этот: эта
основной: основной
подробный: подробнее
разработчик: разработчики
знак: знак
новочеркасск: новочеркасск новочеркасска новочеркасске
отдельный: отдельных
место: место
использование: использования
работать: работал
мелиоратор: мелиоратор
мартаумерший: мартаумершие
михаилович: михайлович
эксплуатационный: эксплуатационных
умереть: умер
преподавательский: преподавательской
германия: германией
сообщить: сообщить
красный: красного
гидромелиоративный: гидромелиоративного
кодистория: кодистория
связаться: свяжитесь
семья: семье
годукавалер: годукавалеры
код: код
страницецитировать: страницецитировать
статьяобсуждение: статьяобсуждение
одновременно: одновременно
руководитель: руководителем
ещё: ещё
новочеркасский: новочеркасская новочеркасского новочеркасской
викидать: викиданных
мелиорация: мелиорация
мочь: могут
русский: русский
аспирант: аспирантом
организовать: организованы
повышение: повышения
рождение: рождения
они: ними
квалификация: квалификации
внести: внёс
память: памяти память
заглавный: заглавная
поведение: поведения
кук: куки
создание: создания
биография: биография
статистика: статистика
заведовать: заведующим
крупный: крупных
последний: последний
сфера: сфера
двадцать: двадцати
текст: текст
участие: участие участии
призвать: призван
заслужить: заслуженный
сост: сост
фёдоров: федоров
заявление: заявление
медаль: медалью
мобильный: мобильная
ростовский: ростовская
править: править
советский: советский советской
отделение: отделение
смерть: смерти
производственный: производственных
сюдасвязанный: сюдасвязанные
ответственность: ответственности
работа: работы
кодекс: кодекс
версия: версия
категория: категории
инструмент: инструменты
выполнить: выполнены
системеобсуждениевкладсоздать: системеобсуждениевкладсоздать
орден: орден ордена
белоусов: белоусова
инженер: инженеры
войныскрытый: войныскрытые
активно: активно
лицензия: лицензии
человек: людях
пространство: пространства
демобилизовать: демобилизован
институт: института
страницыслужебный: страницыслужебные
ссылкамистраница: ссылкамистраницы
ссср: ссср
деятельность: деятельностью
врач: врача
конфиденциальность: конфиденциальности
техникум: техникумов
проектный: проектных
нерабочий: нерабочими
смотреть: см
степень: степени
гидрология: гидрологии гидрология
организация: организации организаций
академия: академия
октябрь: октября
участник: участник
заказ: заказам
товарный: товарный
шумаков: шумаков
зарегистрировать: зарегистрированный
премия: премии
северный: северного
быть: будучи
статьислучайный: статьислучайная
доступный: доступен
скачать: скачать
развитие: развитие
случай: случаях
иван: иван
проект: проектах
павел: павел
фамилия: фамилией
сохранение: сохранением
вклад: вклад
обращение: обращения
доцент: доцентом
узел: узлов
описание: описание
история: истории
другой: других
водоснабжение: водоснабжения
строительство: строительства
источник: источник
кавказ: кавказа
