мы: нами
второй: вторая второго
тодда: тодда
монстр: монстр монстра
группа: групп группа группах группе группой группу группы
категория: категории категория
устранить: устранены
лоренц: лоренца
восьмиугольник: восьмиугольника
действовать: действовать действует действуют действующей действующими
использовать: использующие
иметься: имеется
данный: данное
вложение: вложение
статья: статьи статью
энциклопедия: энциклопедии
читатьправитьправить: читатьправитьправить
унитарный: унитарная
сентябрь: сентября
иметь: имеем имеет имеют имеющих
правкиновое: правкиновые
семейство: семейства
сопряжённость: сопряжённости
полный: полная
который: которая которое
грисс: грисс
перейти: перейти
подфактор: подфактор подфактором
гомеоморфный: гомеоморфным
примечание: примечания
клейн: клейна
свойство: свойства
страницасодержаниеизбрать: страницасодержаниеизбранные
описать: описанные
содержать: содержащая содержит
навигация: навигации навигация
образ: образом
элемент: элемент элемента элементов элементы
являться: является являются являющейся
страница: страница страницы
циклический: циклическая
точка: точек точках
википедия: википедии википедия
топологический: топологические
статьятекущий: статьятекущие
год: года
статьисообществофорумсправкасвежий: статьисообществофорумсправкасвежие
автоморфизм: автоморфизмов автоморфизму
июль: июля
печать: печати
представление: представление представлению представления
проверить: проверить
перестановка: перестановки перестановок
любой: любого
политика: политика
записьвойти: записьвойти
простой: простая простой простые простых
дополнительный: дополнительные дополнительных
один: одна одну
роберт: роберт
максимальный: максимальные максимальный максимальных
фонд: фонд
линейный: линейная
качество: качестве качество
характеристика: характеристике
уэллс: уэллс уэллса
поиск: поиск поиску
страницуполучить: страницуполучить
матричный: матричное
язык: язык языках
статьивикипедия: статьивикипедия
смежность: смежности
шаблон: шаблон шаблонами
силовый: силова
цикл: циклов
просмотр: просмотры
так: т
два: двумя двух
ссылкасведение: ссылкасведения
архивный: архивная
структура: структура структуру
улучшение: улучшения
янко: янко
отказ: отказ
желательно: желательно
событияпожертвовать: событияпожертвовать
спорадический: спорадическая спорадические спорадических
класс: класс класса классами классов классы
указание: указанием
шура: шура
централизатор: централизатор централизатора
викимедиа: викимедиа
свободный: свободное свободной
инволюция: инволюции инволюций
волшебный: волшебные
действительный: действительная
некоммерческий: некоммерческой
удалить: удалите
конечный: конечная конечные конечным конечных
содержание: содержание
согласно: согласно
стилистический: стилистическим
персональный: персональные
указать: указан
условие: условий условия
формировать: формирует
переводвикипедия: переводвикипедия
действие: действие действия
также: также
построить: построили
список: списка
шрайер: шрайера
коксетер: коксетера
авторство: авторства
поле: полем поля
единственный: единственной
её: её
правкипостоянный: правкипостоянная
материал: материал
дата: дата
название: название
отредактировать: отредактирована
ошибкекак: ошибкекак
предсказать: предсказал
счастливый: счастливого счастливым
подгруппа: подгрупп подгруппа подгруппе подгруппой подгруппы
группыскрыть: группыскрытые
имя: имён
понятие: понятия
нормальный: нормальная
архивировать: архивировано
литература: литература
короткий: короткий
представиться: представились
июнь: июня
учётный: учётную
это: это
холл: холл холла
этот: эта
факторгруппа: факторгруппа
поскольку: поскольку
четверной: четверная
англ: англ
перестановочный: перестановочному
подробный: подробнее
разработчик: разработчики
недостаток: недостатки недостатков
знак: знак
удовлетворять: удовлетворяют
отдельный: отдельных
граф: графа графе
использование: использования
вести: ведёт
симс: симса
другой: других другое
теория: теория
преобразование: преобразование
превосходить: превосходит
генерироваться: генерируется
разрешимый: разрешимая
группосновный: группосновные
лемма: лемма
сообщить: сообщить
кодистория: кодистория
связаться: свяжитесь
код: код
страницецитировать: страницецитировать
порядок: порядка порядок
треугольник: треугольника
каждый: каждая
статьяобсуждение: статьяобсуждение
размерность: размерности
ещё: ещё
очередь: очередь
теорема: теорема теоремы
викидать: викиданных
мочь: могут
русский: русский
фурье: фурье
орбита: орбитами
заглавный: заглавная
диэдрический: диэдрическая
иностранный: иностранного
поведение: поведения
матрица: матрицами матрицы
кук: куки
симплектический: симплектическая
перевод: перевода
фишер: фишера
термин: терминах
статистика: статистика
история: история
исключить: исключите
пуанкара: пуанкаре
последний: последний
конвеять: конвея
текст: текст
симметрический: симметрическая
алфавитустраница: алфавитустраницы
стабилизатор: стабилизатор
заявление: заявление
мобильный: мобильная
шесть: шесть
эквивалентный: эквивалентны
править: править
гурвица: гурвица
сюдасвязанный: сюдасвязанные
назвать: назвал
знакопеременный: знакопеременная
ответственность: ответственности
исправление: исправления
копия: копия
кодекс: кодекс
версия: версия
правило: правилам
инструмент: инструменты
индекс: индексом
системеобсуждениевкладсоздать: системеобсуждениевкладсоздать
прямой: прямое
ранг: ранга
звонимир: звонимир
лицензия: лицензии
пространство: пространства
диксон: диксона
произведение: произведение
модулярный: модулярное
обнаруживаться: обнаруживаются
алгоритм: алгоритмы
упорядочить: упорядоченная
изоморфный: изоморфна
страницыслужебный: страницыслужебные
выше: выше
ссылка: ссылки
четыре: четырёх
конфиденциальность: конфиденциальности
смотреть: см
исключительный: исключительные
вершина: вершинах
м: м
некорректный: некорректные
полупрямой: полупрямое
некоторый: некоторые
товарный: товарный
стилистически: стилистически
зарегистрировать: зарегистрированный
смежный: смежными
одноточечный: одноточечный
статьислучайный: статьислучайная
лагранж: лагранжа
доступный: доступен
организация: организации
скачать: скачать
случай: случаях
ортогональный: ортогональная
проект: проектах
коммутативный: коммутативная
уравнение: уравнениям
внешний: внешних
сохранение: сохранением
обращение: обращения
классификация: классификация
описание: описание
участие: участие
матьё: матьё
мультипликатор: мультипликатор
обнаружить: обнаружена
алгебраический: алгебраические
указанный: указанные
плохой: плохой
проблема: проблемы
специальный: специальная
источник: источник
часть: частью
пересечение: пересечение
