войти: войти
массовый: массовой
культурный: культурной культурных
действовать: действовать
подробный: подробнее
областной: областного
статья: статье статьи статью статья
год: гг год года году
дмитрий: дмитрием дмитрий
проверять: проверяема
ошибка: ошибке
ознакомиться: ознакомиться
описание: описание
россия: россией
авторство: авторства
материал: материал
мочь: мог могут можете
журнал: журнал журналы
язык: язык языках языке языком
читатель: читателю
себя: собой
октябрь: октября
заглавный: заглавная
запас: запас
центральный: центральной
рекомендация: рекомендации
век: век
содержание: содержание
болдин: болдин
цель: цели
поиск: поиск поиску
университет: университета
поощрять: поощрял
обсуждение: обсуждение
кук: куки
свежий: свежие
смотреть: см
код: код
вергун: вергун вергуном
инструмент: инструменты
справка: справка
новый: нового новые
страница: страница странице страницу страницы
идти: идти
русофильский: русофильской
участие: участие
элемент: элемент
также: также
сделаться: сделаться
условие: условий условия
издаваться: издававшийся
всеславянский: всеславянский
средство: средства
печатный: печатные печатных
запись: запись
русский: русский русским русской русском русскому
тип: тип
читать: читать
форум: форум
википедия: википедии википедия
представиться: представились
мы: нами
этот: эта
авторитетный: авторитетные
ясный: ясное
преследовать: преследовал
текущий: текущие
подписной: подписная
создать: создать
желание: желанию
правка: правки
добавить: добавив добавить
имя: имён
текст: текст
кодекс: кодекс
номер: номеров
иначе: иначе
история: история
печать: печати
постоянный: постоянная
сильный: сильной
страна: страна
отношение: отношения
сношение: сношений сношения
возникнуть: возникшие
викидать: викиданных
раз: раза
возможность: возможность
мобильный: мобильная
полуостров: полуостровом
алфавит: алфавиту
информация: информации информация
лист: листа листов
энциклопедия: энциклопедии
пространство: пространства
отредактировать: отредактирована отредактировать
настолько: настолько
использовать: использующие
полный: полное
пожертвовать: пожертвовать
правдивый: правдивое
славянство: славянства
доступный: доступен
борьба: борьба
представление: представление
балканский: балканским
объём: объём объёме
знак: знак
источник: источник источники источников
некоммерческий: некоммерческой
весь: весь
дать: дать
славянский: славянская славянский славянского славянскому
непосредственный: непосредственные
рупор: рупор
учётный: учётную
событие: события
получить: получить
рубль: рублей
короткий: короткий
главный: главный
периодичность: периодичность
расширение: расширение
сообщество: сообщество
случай: случаях
сюда: сюда
скачать: скачать
товарный: товарный
викимедиа: викимедиа
заявление: заявление
ответственность: ответственности
месяц: месяц
вклад: вклад
использование: использования
персональный: персональные
случайный: случайная
редактор: редактор
основание: основания
удалить: удалена
литература: литература
система: системе
вып: вып
вена: вене
гланца: гланц
европа: европе
ссылка: ссылка ссылки ссылок
категория: категории
издание: издания
неприкосновенный: неприкосновенный
скрытый: скрытые
сведение: сведения
служебный: служебные
другой: других
сообщить: сообщить
версия: версия
избранный: избранные
торговый: торговые
статистика: статистика
производитель: производителям
некоторый: некоторых
выходить: выходил
отдельный: отдельных
государственный: государственного
лицензия: лицензии
крона: крон
отказ: отказ
проект: проектах
перейти: перейти
сохранение: сохранением
свободный: свободной
речь: речью
указание: указанием
конфиденциальность: конфиденциальности
мировоззрение: мировоззрения
июль: июля
связанный: связанные
навигация: навигации навигация
дата: дата
сноска: сносок
два: двух
торговец: торговцам
ещё: ещё
связаться: свяжитесь
должный: должна
следующий: следующие
поведение: поведения
марка: марок
разработчик: разработчики
вид: виде
московский: московского
дополнительный: дополнительные
славянин: славян
окраска: окраской
время: временем
томаш: томаш
последний: последний
панславистский: панславистская
цитировать: цитировать
жизнь: жизни
организация: организации
хватать: хватает
зарегистрировать: зарегистрированный
фонд: фонд
политика: политика
цена: цена
просмотр: просмотры
франк: франков
вестник: вестник
общий: общим
навстречу: навстречу
править: править
