бродовка: бродовка
шайтанк: шайтанка
мы: нами
отказ: отказ
событияпожертвовать: событияпожертвовать
системеобсуждениевкладсоздать: системеобсуждениевкладсоздать
россия: россии россия
тип: тип
ницырека: ницыреки
карта: картами
викидать: викиданные викиданных
вязовка: вязовка
русый: рус
водный: водная водного водном водные водный
синячих: синячиха
позапозапрошлый: позапозапрошлом
бассейновый: бассейнового бассейновому
сообщить: сообщить
иртышский: иртышского иртышскому
карский: карское
ирбитский: ирбитского ирбитское
район: район
ельничный: ельничный
государственный: государственного государственном государственный
муниципальный: муниципального муниципальное
река: рек река реки
реж: реж
длина: длина
вып: вып
башкарка: башкарка
система: система
изображение: изображений
местоположение: местоположение
лицензия: лицензии
ред: ред
кодистория: кодистория
связаться: свяжитесь
указание: указанием
пространство: пространства
ямбарка: ямбарка
код: код
координата: координаты
страницецитировать: страницецитировать
минприрода: минприроды
ежуковка: ежуковка
чубаровка: чубаровка
гкгнпро: гкгнпро
дальний: дальний дальняя
викимедиа: викимедиа
страница: страница страницы
устье: устье устья
свободный: свободной
страницыслужебный: страницыслужебные
размер: размер
талица: талица
статья: статьи
ссылка: ссылки
малый: малая малый
липовка: липовка
энциклопедия: энциклопедии
читатьправитьправить: читатьправитьправить
некоммерческий: некоммерческой
протекать: протекает
шогриша: шогриш
участок: участок
иленка: иленка
ссср: ссср
устиновка: устиновка
арамашка: арамашка
статьяобсуждение: статьяобсуждение
кочёвка: кочевка
чистый: чистая
ляга: ляга
ещё: ещё
страна: страна
конфиденциальность: конфиденциальности
булнаш: булнаш
голый: голая
правкиновое: правкиновые
объект: объекта объекты
свердловский: свердловская свердловской
алапаиха: алапаиха
изученность: изученность
смотреть: см
ресурс: ресурсы
расположение: расположение
персональный: персональные
тур: тура
образование: образование
номер: номер
перейти: перейти
мочь: могут
широта: ш
мостовка: мостовка
русский: русский
условие: условий условия
примечание: примечания
реестр: реестр реестра реестре
таложанк: таложанка
страницасодержаниеизбрать: страницасодержаниеизбранные
глинка: глинка
кокуйка: кокуйка
обь: обь
навигация: навигации навигация
буланиха: буланиха
округарек: округареки
элемент: элемент
товарный: товарный
ближний: ближний ближняя
озёрный: озёрная
гвркарточка: гвркарточка
мостовушка: мостовушка
киселёвка: киселевка
авторство: авторства
зарегистрировать: зарегистрированный
становой: становая
половинный: половинная
википедия: википедии википедия
леневка: леневка
сараевка: сараевка
заглавный: заглавная
больший: большая
материал: материал
дата: дата
шуралка: шуралка
статьятекущий: статьятекущие
правкипостоянный: правкипостоянная
характеристика: характеристика
символовпро: символовпро
статьисообществофорумсправкасвежий: статьисообществофорумсправкасвежие
северный: северная
поведение: поведения
алабашка: алабашка
кук: куки
публикация: публикации
шаровка: шаровка
февраль: февраля
ница: ница ницы
быньга: быньга
отредактировать: отредактирована
менее: менее
ошибкекак: ошибкекак
печать: печати
водоток: водоток
грязнуха: грязнуха
относиться: относится
нейва: нейва
антоновка: антоновка
илёнька: иленька
черепанк: черепанка
бассейнавикипедия: бассейнавикипедия
море: море
политика: политика
последний: последний последняя
поварёнок: поваренка
указать: указано
годукарточка: годукарточка
статьислучайный: статьислучайная
статистика: статистика
имя: имён
записьвойти: записьвойти
действовать: действовать
доступный: доступен
гвр: гвр
алфавитукарточка: алфавитукарточка
дополнительный: дополнительные
область: области область
организация: организации
средний: средний
свойство: свойство
км: км
таволга: таволга
подбассейн: подбассейн
пашковка: пашковка
гидрологический: гидрологическая
короткий: короткий
косогорка: косогорка
скачать: скачать
гкгна: гкгн
обуховка: обуховка
представиться: представились
захарьиха: захарьиха
южный: южная
случай: случаях
шавушко: шавушка
площадь: площадь
текст: текст
адуть: адуй
бассейн: бассейн
иртыш: иртыш
исток: исток
мурза: мурза
большой: большой
учётный: учётную
проект: проектах
фонд: фонд
трестовка: трестовка
этот: эта
шиловка: шиловка
слияние: слияния
хвощёвка: хвощевка
заявление: заявление
поиск: поиск поиску
регион: регион
татарка: татарка
образованияскрыть: образованияскрытые
сусанк: сусанка
толмачих: толмачиха
страницуполучить: страницуполучить
сохранение: сохранением
округа: округу
сарабайка: сарабайка
мобильный: мобильная
править: править
буланаш: буланаш
межница: межница
есаулка: есаулка
язык: языках
подробный: подробнее
разработчик: разработчики
алфавитуприток: алфавитупритоки
водохозяйственный: водохозяйственный
знак: знак
поверхностный: поверхностных
ленёвка: ленёвка
ермених: ермениха
аять: аять
сюдасвязанный: сюдасвязанные
отдельный: отдельных
описание: описание
участие: участие
таборк: таборка
бунарк: бунарка
кирга: кирга
тобол: тобол
крутой: крутая
сап: сап
другой: других
урал: урал
использование: использования
ответственность: ответственности
скопинский: скопинская
составлять: составляет
бичура: бичур
заполнить: заполнить
находиться: находится
продольный: продольная
гидрометеоиздат: гидрометеоиздат
приуралье: приуралье
режик: режик
просмотр: просмотры
данные: данным
кодекс: кодекс
так: т
версия: версия
дать: данные
чурманка: чурманка
беляковка: беляковка
речной: речной
категория: категории
правый: правому
ссылкасведение: ссылкасведения
николаенко: николаенко
источник: источник
ирбит: ирбит
инструмент: инструменты
правка: правка
вода: вод
берег: берегу
