войти: войти
составлять: составляет
страшевич: страшевичи
прошлый: прошлом
ям: ям
мишутиный: мишутино
количество: количество
описание: описание
авторство: авторства
федеральный: федеральная федеральный
альфимовый: альфимово
материал: материал
всероссийский: всероссийская
торжокский: торжокский торжокского торжокском
аннино: аннино
нестеровый: нестерово
яконовый: яконово
красный: красная красное красные красный
поиск: поиск поиску
сельцо: сельцо
помазкино: помазкино
инструмент: инструменты
шуколово: шуколово
страница: страница странице страницу страницы
слепетовый: слепетово
район: район района районе районов
кужлевый: кужлево
обращение: обращения
чеграево: чеграево
кунганово: кунганово
якутиный: якутино
дорофейк: дорофейки
ветер: ветра
тип: тип
кречетовый: кречетово
ступневый: ступнево
представиться: представились
область: области область
юрьицевый: юрьицево
кисляковый: кисляково
боярский: боярское
торжок: торжка торжок
петропавлово: петропавлово
волосовый: волосово
васьковый: васьково
богородецкий: богородецкое
скрябино: скрябино
коротковый: коротково
черниговый: чернигово
километр: километров
кузовковый: кузовково
текст: текст
кодекс: кодекс
бараново: бараново
умеренно: умеренно
беркаево: беркаево
лесной: лесная лесных
указать: указан
александрово: александрово
тетерлевый: тетерлево
горощино: горощино
поведскай: поведская
русский: русский русской
кляковый: кляково
ягодкино: ягодкино
васильковый: васильково
скрипковый: скрипково
нива: нива нивы
тимофеево: тимофеево
непоровый: непорово
россия: россии россия
старое: старое
костромино: костромино
событие: события
природный: природных
пункт: пунктов пункты
симоново: симоново
случай: случаях
высокий: высокое
карта: картами карты
максимум: максимум
русиный: русино
юрьев: юрьево
любоховый: любохово
шевелиный: шевелино
малиновка: малиновка
результат: результатам
крупшевый: крупшево
якшиный: якшино
глядиня: глядини
статья: статьи статья
дубровка: дубровка
среднегодовой: среднегодовая
покров: покров
корытниковый: корытниково
арпачёво: арпачёво
пышковый: пышково
скрытый: скрытые
песочень: песочня
население: население населения
лес: лесов
машкино: машкино
октмый: октмо
план: плана
межостровый: межострово
служебный: служебные
атмосферный: атмосферных
условие: условий условия
поведь: поведь
подол: подолы
версия: версия
перечень: перечня
индекс: индекс
дуловый: дулово
копия: копии
г: г
расстояние: расстоянии
приказ: приказ
который: которых
округ: округа
кресиный: кресино
святцовый: святцово
садка: садок
пироговый: пирогово
спасс: спасс
торфяник: торфяник
перейти: перейти
тимошкино: тимошкино
идентификатор: идентификаторы
глёбово: глебово
глинка: глинки
бродниковый: бродниково
связаться: свяжитесь
козловый: козлово
житниковый: житниково
подсосение: подсосенье
петров: петрово
челядин: челядино
берёзка: березки
еремкино: еремкино
набережный: набережный
будовский: будовского будовское
боровой: боровое
владычень: владычня
слоново: слоново
чигариха: чигариха
административный: административного
поречье: поречье
течение: течение
архивировать: архивировано
крест: кресты
афримовый: афримово
костино: костино
карцовый: карцово
радиловый: радилово
головинский: головинские
март: марта
василёвый: василёво
фонд: фонд
холодное: холодного
жеротин: жеротино
варьировать: варьирует
заболотья: заболотье
мочь: могут
внуково: внуково
навигация: навигации навигация
состав: состав
климовый: климово
пестово: пестово
период: период
относительно: относительно
исаковый: исаково
подолец: подольцы
скорость: скорость
перепись: переписи перепись
якимовый: якимово
заглавный: заглавная
октябрь: октября
бородино: бородино
дитяткино: дитяткино
содержание: содержание
переслегино: переслегино
дарище: дарище
м: м
малиновый: малиново
мошка: мошки
код: код
заречье: заречье
горица: горицы
московский: московское
лесорастительный: лесорастительных
осуйский: осуйское
поселение: поселение поселения
андриановый: андрианово
рязаново: рязаново
медведково: медведково
зябриковый: зябриково
недоступный: недоступная недоступные
широта: ш
значение: значения
пудышевый: пудышево
бурчих: бурчиха
день: дней
измайлово: измайлово
барсук: барсуки
любиня: любини
этот: эта
попов: попово
трубино: трубино
васильцево: васильцево
горка: горка горки
митино: митино
часть: части часть
соколово: соколово
населить: населённых
анненский: анненское
больница: больница
правка: правка правки
раменье: раменье
машутиный: машутино
черневый: чернево
источник: источник источниками
теткино: теткино
пожитовый: пожитово
чупровый: чупрово
терешкино: терешкино
государственный: государственная
кочить: кочено
медухов: медухово
галка: галки
ресурс: ресурсов
владенино: владенино
зизино: зизино
алфавит: алфавиту
год: года году
численность: численность
малый: малая малое малый
перцовый: перцово
дубка: дубки
алексейковый: алексейково
федерация: федерации
рашкино: рашкино
пожертвовать: пожертвовать
матюковый: матюково
бунятино: бунятино
язык: язык языках
мануйловый: мануйлово
рыловый: рылово
некоммерческий: некоммерческой
фомин: фомино
зеленцино: зеленцино
лужковый: лужково
снежный: снежный
логовежа: логовежи
лепешкино: лепешкино
система: система системе
сообщество: сообщество
голенищево: голенищево
заявление: заявление
понкратово: понкратово
замушие: замушье
коршевый: коршево
май: мая
отрадный: отрадное
крюково: крюково
гусенец: гусенец
ответственность: ответственности
жилкино: жилкино
островок: островок
таложнить: таложня
утверждение: утверждении
коноплище: коноплище
буконтовый: буконтово
стояново: стояново
тимонцевый: тимонцево
зона: зон зоне
круглый: круглое
глазун: глазуны
персональный: персональные
толстиковый: толстиково
отредактировать: отредактирована
минимум: минимум
бабино: бабино
зоря: зори
география: география
жданово: жданово
дар: дары
прутень: прутня
михайловый: михайлово
щёкино: щёкино
применять: применяемого
лопатин: лопатино
паника: паника
ссылка: ссылка ссылки
орехово: орехово
копырян: копыряне
филитовый: филитово
вегетационный: вегетационный
человек: человек
населённый: населённые
барыковый: барыково
троицкий: троицкое
нп: нп
сообщить: сообщить
субъект: субъект
гарь: гари
пояс: пояс
погорельцево: погорельцево
википедия: википедии википедия
избранный: избранные
захожие: захожье
тупиковый: тупиково
климат: климат
кочеровый: кочерово
скомороховый: скоморохово
детковый: детково
лицензия: лицензии
боркино: боркино
думаново: думаново
андреево: андреево
удальцово: удальцово
смещение: смещение
никольский: никольское
ещё: ещё
ескино: ескино
щербовый: щербово
гора: гора горы
гальковый: гальково
примерно: примерно
сосенка: сосенка
чевакино: чевакино
липиго: липига
цифровой: цифровые
мм: мм
вишенье: вишенье
славный: славный
больший: большая
лавровый: лаврово
жулевый: жулево
неопр: неопр
восток: востоку
править: править
вишенка: вишенки
телицино: телицино
андриянцевый: андриянцево
клоковый: клоково
действовать: действовать
костерево: костерево
подробный: подробнее
ошибка: ошибке
часовой: часовой
домославль: домославль
клин: клин
воронец: воронцы
конышковый: конышково
патраковый: патраково
центральный: центральной
месяц: месяца
исчисление: исчислении
мартыново: мартыново
статус: статус
база: база
строевич: строевичи
море: моря
обсуждение: обсуждение
кук: куки
муниципальный: муниципальный
последний: последний последняя
елизаветиный: елизаветино
житковый: житково
горянка: горянка
участие: участие
погореловый: погорелово
копкино: копкино
запись: запись
характеризоваться: характеризуется
форум: форум
министерство: министерства
новинка: новинки
тверской: тверской
согласно: согласно
семёновский: семёновское
национальность: национальности
анцифоровый: анцифорово
будовый: будово
создать: создать
нохчийна: нохчийн
имя: имён
бибиковый: бибиково
цапушевый: цапушево
щиловый: щилово
стукшиный: стукшино
архивный: архивной
печать: печати
щемелинино: щемелинино
восточный: восточной
песчанка: песчанки
бернишить: бернишено
игнатьевый: игнатьево
казицино: казицино
явидовый: явидово
костромка: костромка
валдайский: валдайской
семенковый: семенково
горшковый: горшково
тёплый: тёплого тёплый тёплым
постоянный: постоянная
бережок: бережок
тимонино: тимонино
воропуня: воропуни
страна: страна
журавка: журавки
город: город города
викидать: викиданных
зелёный: зелёная зелёный
киселенка: киселенка
закон: закон
богатьковый: богатьково
бубеньев: бубеньево
воробьёвый: воробьёво
куровый: курово
падерин: падерино
пространство: пространства
восец: восцы
сахариха: сахариха
тредубьё: тредубье
борисцевый: борисцево
булатниковый: булатниково
млевич: млевичи
грузин: грузины
павлушкин: павлушкино
знак: знак
голобовый: голобово
меленки: меленки
чайкино: чайкино
получить: получить
поломеница: поломеницы
раменки: раменки
сафониха: сафониха
самотёлка: самотёлки
спировый: спирово
генеральный: генерального
товарный: товарный
сюда: сюда
скачать: скачать
леушкино: леушкино
мякинница: мякинница
быльцино: быльцино
колёсный: колёсные
степурино: степурино
упирвич: упирвичи
худяковый: худяково
вклад: вклад
хлыщево: хлыщево
пятница: пятница
фгис: фгис
сывороткино: сывороткино
ушаковый: ушаково
бачеровый: бачерово
никола: никола
колодино: колодино
длиться: длится
сведение: сведения
лыковый: лыково
победа: победа
березать: березай
другой: другие других
снегирёвый: снегирёво
яковлевский: яковлевское
прусовый: прусово
каряево: каряево
хребтовый: хребтово
борок: борок
дмитровский: дмитровское
июнь: июня
бобёр: бобров
тверь: тверь
морозный: морозной
луняковый: луняково
селихов: селихово
годовой: годовое
сельский: сельского сельское
соколиный: соколино
битьковый: битьково
русый: рус
июль: июля
деревня: деревне деревня
абсолютный: абсолютная абсолютный
печка: печки
куклиный: куклино
влажный: влажный
еменово: еменово
задорья: задорье
глуховый: глухово
коробовый: коробово
городок: городок
держаться: держится
осиповый: осипово
ладьиный: ладьино
цитировать: цитировать
гудковый: гудково
сверчковый: сверчково
континентальный: континентальный
весь: вся
смердовый: смердово
тверская: тверская
зарегистрировать: зарегистрированный
политика: политика
окато: окато
данные: данных
андрюшиный: андрюшино
нижний: нижнее
редькино: редькино
просмотр: просмотры
нежданово: нежданово
плот: плот
центр: центр центра
бавыкино: бавыкино
чуриковый: чуриково
саполово: саполово
селестровый: селестрово
брячковый: брячково
новый: новое новые
заполье: заполье
заря: заря
дудоровый: дудорово
аксёново: аксёново
латибровый: латиброво
сотин: сотино
бутивица: бутивицы
свежий: свежие
смотреть: см
рамушка: рамушки
дурулино: дурулино
информационный: информационная
льнозавод: льнозавод
проект: проект проектах
колосовый: колосово
справка: справка
планирование: планирования
логуново: логуново
бахани: бахани
николаевка: николаевка
москва: москва
прямой: прямой
шумчиный: шумчино
элемент: элемент
районный: районный
рожново: рожново
время: времени время
читать: читать
бора: бор
возвышенность: возвышенности
пашин: пашино
савинский: савинские савинское
проживать: проживал
мы: нами
струбище: струбище
житель: житель
текущий: текущие
маслово: маслово
богуново: богуново
багаиха: багаиха
васильев: васильева васильево
первый: первое
сам: самого
топоним: топонима
кафтырево: кафтырево
скрылевый: скрылево
трясёнок: трясенка
коробино: коробино
сукромль: сукромля
мельгубовый: мельгубово
история: история
около: около
тп: тп
екатин: екатино
рябиниха: рябиниха
степанковый: степанково
мобильный: мобильная
макарьино: макарьино
рюмин: рюмино
энциклопедия: энциклопедии
дмитровка: дмитровка
корзовый: корзово
оконечность: оконечности
доступный: доступен
почтовый: почтовый
ляхово: ляхово
добрыня: добрыни
учётный: учётную
шубино: шубино
температура: температура
синцовый: синцово
территориальный: территориального
костковый: костково
короткий: короткий
кожевниковый: кожевниково
парневый: парнево
викимедиа: викимедиа
загорье: загорье
восход: восход
александровка: александровка
еремейк: еремейки
абакумов: абакумово
ременевый: ременево
чернава: чернавы
городской: городского
река: реки
стружний: стружня
нерудный: нерудный
сосновка: сосновка
использование: использования
случайный: случайная
мякинницкий: мякинницкий
иванковый: иванково
коптево: коптево
захаркино: захаркино
мишковый: мишково
находиться: находится
ванеево: ванеево
василевый: василево
карпеево: карпеево
зимой: зимой
шепетовый: шепетово
категория: категории
лето: летом
марьино: марьино
предел: пределах
миронежие: миронежье
мск: мск
смыковый: смыково
национальный: национальный
китовый: китово
кашаево: кашаево
негоново: негоново
отдельный: отдельных
новгородский: новгородское
высота: высота
отказ: отказ
осташковый: осташково
раёк: раёк
ряхово: ряхово
упрышкино: упрышкино
шеметовый: шеметово
сохранение: сохранением
свободный: свободной
хотиново: хотиново
доншиный: доншино
указание: указанием
конфиденциальность: конфиденциальности
ерешкино: ерешкино
возжанк: возжанки
метр: метров
связанный: связанные
симонковый: симонково
дата: дата
поведение: поведения
великоселье: великоселье
фомишиха: фомишиха
разработчик: разработчики
поддубьё: поддубье
дополнительный: дополнительные
маркашин: маркашино
воздух: воздуха
зенцовый: зенцово
входить: входит
ильин: ильино
прутёнок: прутенка
свищево: свищево
изображение: изображений
коряк: коряков
бессменино: бессменино
примечание: примечания
можайцевый: можайцево
чудин: чудины
большой: большое
организация: организации
немчиный: немчино
уровень: уровнем
российский: российской
обуховый: обухово
рудниковый: рудниково
январь: января
ефрёмово: ефремово
тверецкий: тверецкий
средний: средняя
бель: бели
осадки: осадков
выпадать: выпадает
костешиный: костешино
статистика: статистика
мирный: мирный
