войти: войти вошла
сюжет: сюжетов
недомогание: недомогание
спрингфилд: спрингфилде
викицитатник: викицитатнике
описание: описание
авторство: авторства
концерт: концертах
материал: материал
новый: новая новой новые
ювелир: ювелиром
поиск: поиск поиску
внешний: внешние
музыка: музыке музыки музыку
инструмент: инструменты
поллианна: поллианна поллианне поллианны
страница: страница странице страницу страницы
несмотря: несмотря
значительно: значительно
главный: главной главных
обращение: обращения
юношество: юношества
выпустить: выпустила
пережить: пережила
переиздание: переизданий
гутенберг: гутенберг
библиографический: библиографических
портер: портер портера
отказаться: отказаться
представиться: представились
выпускник: выпускники
родиться: род родившиеся родилась родился
жизнь: жизни жизнь
честь: честь
текст: текст
кодекс: кодекс
брат: брат
кэмбридж: кэмбридже
копия: копия
постановка: постановке
инвалид: инвалидов
видеть: видел
викисклад: викисклад викискладе
указать: указан
генеалогия: генеалогия
медиафайл: медиафайлы
роман: роман романов роману романы
апрель: апреля
мать: мать
гражданство: гражданство
фрэда: фрэд
использовать: использующие
аста: аст
онлайн: онлайн
церковь: церкви
событие: события
течение: течения
сочинение: сочинения
вырасти: выросла
продолжение: продолжение
писатель: писателей писатели писатель
случай: случаях
тягота: тяготам
благодаря: благодаря
американский: американская американский
отличаться: отличалась отличаться
прийти: пришёл
девчонка: девчонку
заполнить: заполнить
ресурс: ресурсы
дочь: дочерью
штат: штат
чаттануга: чаттануге
статья: статьи статья
скрытый: скрытые
служебный: служебные
условие: условий условия
версия: версии версия
героиня: героиней героиня
благосклонно: благосклонно
место: местах место
появляться: появляется
общеобразовательный: общеобразовательной
успех: успех успеху
перейти: перейдя перейти
четыре: четыре
англ: англ
встретить: встретить встречена
миллион: миллионов
мнение: мнению
связаться: свяжитесь
эмиль: эмили
прибавить: прибавил
критик: критиками критиков
детство: детства
образование: образование
производство: производства производство
правка: правки правок
надпись: надпись
каждый: каждый
мамедов: мамедова
архивировать: архивировано
поверхностность: поверхностность
миссис: миссис
известный: известен известная
отмечаться: отмечается
талант: талант
фонд: фонд
подданство: подданство
продолжать: продолжала
мочь: могут
писательница: писательница писательнице писательницы
лига: лига
поздний: позже
надгробие: надгробие надгробии
навигация: навигации навигация
смерть: смерти смерть
консерватория: консерватории консерватория
год: год года году лет
путь: путь
непустой: непустое
октябрь: октября
местный: местных
план: планы
волшебный: волшебные
заглавный: заглавная
содержание: содержание
бестселлер: бестселлеров
февраль: февраля
занятие: занятиям
любитель: любителей
код: код
выступать: выступала
вскоре: вскоре
бостон: бостоне
её: её
викитека: викитеке
школа: школы
входить: входили
весь: всем
счастливый: счастливая
джон: джона
этот: эта
список: список
дом: доме
принцип: принцип
свой: свои своим
человек: людей людях
фильм: фильм
литлтоня: литлтоне
выдающийся: выдающихся
алфавит: алфавиту
ранка: ранок
архивный: архивная
русский: русский русском
пожертвовать: пожертвовать
пикфорд: пикфорд
домашний: домашнее
восемь: восьми
сборник: сборников
вымышленный: вымышленного
язык: язык языках языке языков
некоммерческий: некоммерческой
биография: биография
дедушка: дедушка
письмо: письма
память: памяти память
расширение: расширение
сообщество: сообщество
заявление: заявление
словарь: словари
элинор: элинор
май: мая
рассказ: рассказов рассказы
ответственность: ответственности
персональный: персональные
отредактировать: отредактирована
саратов: саратов
система: системе
вынудить: вынуждена
норвежский: норвежская
фармацевт: фармацевта
жанр: жанр
проверка: проверки
тот: тех той
который: которая которые
ссылка: ссылка ссылки
экранизация: экранизации
грядущий: грядущее
сообщить: сообщить
имя: имя имён
чей: чьи
произведение: произведений произведения произведениях
избранный: избранные
википедия: википедии википедия
забросить: забросила
проверить: проверенной
лицензия: лицензии
эрлить: эрли
век: века
старший: старший
вулсон: вулсон
лёгкий: лёгкое
обучение: обучение
уитьер: уитьер
выйти: вышел вышла
ребёнок: детей ребёнком
ещё: ещё
следующий: следующие
проект: проект проектах проекте
первый: первый первым
мэри: мэри
пер: пер
кембридж: кембридж кембридже
склонность: склонность
свет: свет
литлтон: литлтон
строить: строила
хор: хоре
америка: америка
универсальный: универсальная
больший: большая
неопр: неопр
повесть: повести
ч: ч
править: править
памятник: памятник
литовский: литовская
действовать: действовать
ступить: ступила
хороший: лучших хороших
подробный: подробнее
декабрь: декабре декабря
ошибка: ошибке
вырастать: вырастает
бумага: бумаги
ряд: ряду
полли: полли
обсуждение: обсуждение
кук: куки
пара: пары
младший: младшим
сохранять: сохраняет сохраняют
устинов: устинова
решение: решение
участие: участие
известность: известность
книга: книг книга
деревня: деревне деревни
запись: запись
форум: форум
создать: создать
мисс: мисс
самый: самая
сайт: сайты
телефильм: телефильм
печать: печати
поскольку: поскольку
постоянный: постоянная
стать: стала
таир: таира
обосноваться: обосновавшимся обосновались
страна: страна
викидать: викиданных
ходжмена: ходжмен ходжмена
сша: сша
пространство: пространства
спустя: спустя
знак: знак
церковный: церковном
получить: получила получить
обучаться: обучалась
комикс: комиксе
товарный: товарный
шаблон: шаблон
сюда: сюда
скачать: скачать
детский: детские
адаптировать: адаптирована
художественный: художественный
вклад: вклад
широкий: широкую
требовать: требуют
урожд: урожд
опытный: опытными
музыкальный: музыкальный
крепкий: крепким
бизнесмен: бизнесмена
викиновость: викиновости
сведение: сведения
издание: издания
лето: лето
другой: других
српскохрватски: српскохрватски
сочинять: сочинять
цитата: цитаты
десять: десяти
конгрегационалистский: конгрегационалистской
газета: газетах
урок: уроки
выход: выхода
алан: алана
недостаточный: недостаточный
июль: июля
значение: значение
мультфильм: мультфильм
вопреки: вопреки
перевести: переведена
высечь: высечена
роль: роли
история: истории история
цитировать: цитировать
билли: билли
некрополистик: некрополистика
лиман: лимана
джентльмен: джентльменов
зарегистрировать: зарегистрированный
политика: политика
батищев: батищевой
просмотр: просмотры
умереть: умерла
психология: психологии
публиковать: публиковала
рождение: рождении рождения
единственный: единственной
читатель: читателями
ежегодный: ежегодный
посещение: посещения
пожить: пожить
нечаев: нечаевой
участник: участниками
мой: мою
свежий: свежие
смотреть: см
фрэнсис: фрэнсис фрэнсиса
справка: справка
проверяться: проверялась
дартмут: дартмуте
предок: предки
последовать: последовало
элемент: элемент
написать: написала
български: български
создавать: создавала
читать: читать
мы: нами
массачусетс: массачусетс
проживать: проживала
текущий: текущая текущие
успеть: успели
время: время
луэлла: луэллы
родный: родном
жена: жены
махаон: махаон
мобильный: мобильная
комедия: комедии
оптимизм: оптимизм
энциклопедия: энциклопедии
давид: давид
умерший: умершие
здоровье: здоровьем
театральный: театральной
деятельность: деятельности
доступный: доступен
свойство: свойство
источник: источник
учётный: учётную
магомет: магомета
короткий: короткий
тематический: тематические
черновик: черновики
просто: просто
викимедиа: викимедиа
выходить: выходит
относиться: относилась
проявлять: проявляла
большой: большом
использование: использования
журнал: журналах
случайный: случайная
каталог: каталогах
пока: пока
мур: мура
посягательство: посягательства
встречный: встречные
англия: англии
киев: киев
город: городе
флэтчер: флэтчера
персоналия: персоналии
категория: категории
романтический: романтической
фамилия: фамилией
испытывать: испытывала
привнести: привнесли
гриффин: гриффина
изображение: изображениями
отдельный: отдельных
отказ: отказ
сочинительство: сочинительству
сохранение: сохранением
свободный: свободной
солнечный: солнечный
указание: указанием
конфиденциальность: конфиденциальности
иванов: иванов
стоить: стоит
связанный: связанные
дата: дата
слишком: слишком
мюзикл: мюзиклу
часто: часто
поведение: поведения
фрэнч: фрэнч
разработчик: разработчики
несколько: несколько
дополнительный: дополнительные
часовщик: часовщиком
давать: давала
день: день
последний: последний
японский: японский
июнь: июнь
примечание: примечания
организация: организации
неожиданность: неожиданностью
пение: пению
замуж: замуж
январь: января
интересный: интересные
статистика: статистика
фармацевтика: фармацевтику
