войти: войти
великий: великий
описание: описание
авторство: авторства
материал: материал
флора: флора
поиск: поиск поиску
инструмент: инструменты
велханс: велханс
страница: страница странице страницу страницы
лаз: лазы
имя: имени имён
также: также
примета: приметы
конкордия: конкордия
тип: тип
представиться: представились
фавн: фавн фавна
священный: священный
арвальский: арвальские
персонаж: персонаж персонажи
тагес: тагес
римлянин: римлян
честь: честь
юнона: юнона
текст: текст
кодекс: кодекс
рассматриваться: рассматривались
тална: тална
выпадать: выпадали
юпитер: юпитер
совпадение: совпадения
староримский: староримскому
апрель: апреля
пиетас: пиетас
использовать: использующие
либертас: либертас
событие: события
случай: случаях
гаруспик: гаруспик
минерв: минерва
российский: российского
сол: сол
статья: статьи статья
скрытый: скрытые
полнолуние: полнолуние
служебный: служебные
обычай: обычаи
лата: лат
условие: условий условия
версия: версия
тухулха: тухулха
фламин: фламины
веста: веста
вольтумный: вольтумна
коллегия: коллегия
вагитана: вагитан
турмс: турмс
перейти: перейти
англ: англ
храм: храм
связаться: свяжитесь
незавершённый: незавершённые
гений: гении
детство: детства
народный: народные
хара: хару
лемурия: лемурия
фонд: фонд
мочь: могут
навигация: навигации навигация
февраль: февраль февраля
смерть: смерти смерть
луперкалия: луперкалии луперкалий луперкалиями
геркл: геркле
заглавный: заглавная
волшебный: волшебные
заготовка: заготовка
содержание: содержание
м: м
нефунс: нефунс
подземный: подземного подземное
код: код
жрец: жрецы
празднество: празднеством
её: её
пенаты: пенаты
бог: бог бога боги богом
грошев: грошев
этот: эта
сатурналии: сатурналии
эпулона: эпулоны
правка: правка правки
мужской: мужской
богатство: богатства
фидес: фидес
консуалии: консуалии
менров: менрва
алфавит: алфавиту
год: году
хонос: хонос
авгур: авгуры
ритуал: ритуалы
обитать: обитают
русский: русский
пожертвовать: пожертвовать
кулсан: кулсан
язык: языках
ауспиция: ауспиция
некоммерческий: некоммерческой
мифология: мифологии мифология
танр: танр
сообщество: сообщество
заявление: заявление
ответственность: ответственности
везуна: везуна
персональный: персональные
отредактировать: отредактирована
литература: литература
система: системе
календарь: календарь календарю
главный: главные
кал: калу
меркурий: меркурий
понтифик: понтифик понтификов
который: которые
фебрууса: фебрууса
ссылка: ссылка ссылки
древнеримский: древнеримская древнеримской
нептуналия: нептуналии
сообщить: сообщить
игра: игры
избранный: избранные
википедия: википедии википедия
эвентус: эвентус
царь: царь
норция: норция
лицензия: лицензии
лара: лары
податель: податель
беллоно: беллона
римский: римской
ещё: ещё
сатр: сатре
земледелец: земледельца
параметр: параметров
бон: бона
пол: пол
оркус: оркус
вд: вд
триада: триада
сивилла: сивилл
конс: конс
мифологический: мифологические
править: править
морс: морс
действовать: действовать
подробный: подробнее
ошибка: ошибке
фр: фр
лунный: лунному
месяц: месяца
совет: совет
функция: функции
обсуждение: обсуждение
кук: куки
последний: последний последняя
цереалия: цереалии
кибел: кибела
участие: участие
брат: братья
верование: верования
айта: айта
фебруус: фебруус
душа: души
запись: запись
форум: форум
антина: антиной
уни: уни
создать: создать
деа: деа
мариса: марис
церер: церера
этрусский: этрусская этрусский
печать: печати
секулярный: секулярные
виртус: виртус
постоянный: постоянная
земледелие: земледелия
викидать: викиданных
обряд: обряды
пространство: пространства
вегойя: вегойя
знак: знак
спёс: спес
праздник: праздник праздники
получить: получить
аннона: аннона
этернитас: этернитас
товарный: товарный
сюда: сюда
скачать: скачать
вклад: вклад
мантус: мантус
помон: помона
купидон: купидон
сведение: сведения
паренталия: паренталии
мана: маны
сефланс: сефланс
матроналия: матроналии
другой: другие других
ювеналий: ювеналии
фуфлунс: фуфлунс
название: название
царство: царства царство
янус: янус
ритуальный: ритуальное
цитировать: цитировать
приходиться: приходились
зарегистрировать: зарегистрированный
политика: политика
просмотр: просмотры
позапрошлый: позапрошлом
рома: рома
сури: сури
флоралия: флоралии
фециал: фециалы
помочь: помогите
теллус: теллус
леф: лефам
секуритас: секуритас
свежий: свежие
смотреть: см
плутон: плутон
книга: книги
справка: справка
новый: новые
аритий: аритими
ванта: вант
элемент: элемент
диес: диес
религия: религии религия
фортуна: фортуна
время: времени
вулкан: вулкан
читать: читать
очищение: очищение очищения
мы: нами
сфера: сфера
весталка: весталки
текущий: текущие
совпадать: совпадали
дух: духи
квирина: квирин
карточка: карточки
история: история
алпан: алпан
мобильный: мобильная
мифический: мифический
усила: усил
пантеон: пантеон
апл: аплу
салий: салии
сатурн: сатурн
энциклопедия: энциклопедии
леван: левана
божество: божества
умерший: умерших
доступный: доступен
туран: туран
кильный: килен
источник: источник
квинкватрия: квинкватрии
учётный: учётную
венера: венера
диоскура: диоскуры
ангерон: ангерона
капитолийский: капитолийская
короткий: короткий
дополнить: дополнив
тиции: тиции
викимедиа: викимедиа
малый: малые
использование: использования
случайный: случайная
категория: категории
мания: мания
марс: марс
мир: мира
отдельный: отдельных
тиния: тиния
фесан: фесан
отказ: отказ
происходить: происходит
проект: проектах
аполлон: аполлон
аврора: аврора
свободный: свободной
сохранение: сохранением
указание: указанием
конфиденциальность: конфиденциальности
приап: приап
диана: диана
ларан: ларан
связанный: связанные
часто: часто
загробный: загробного
поведение: поведения
выполнять: выполнял
разработчик: разработчики
персонификация: персонификация
дополнительный: дополнительные
влияние: влияния
августалый: августалы
семл: семла
это: это
изображение: изображений
примечание: примечания
мсха: мсха
организация: организации
итал: итал
нептун: нептун
статистика: статистика
