войти: войти
комитис: комитис комитиса
кпм: кпм
этот: эта этому
заявить: заявил
кейптаун: кейптаун кейптауна кейптауне
описание: описание
авторство: авторства
материал: материал
такой: такого
назначить: назначен
поиск: поиск поиску
внешний: внешние
раздел: разделами разделе
инструмент: инструменты
слияние: слияния
команда: команд
страница: страниц страница странице страницу страницы
южный: южной
владелец: владелец
несмотря: несмотря
обращение: обращения
также: также
тип: тип
представиться: представились
домашний: домашние
родиться: родился
ноябрь: ноября
текст: текст
кодекс: кодекс
переименование: переименовании переименованию переименования
иначе: иначе
твиттер: твиттер
указать: указан
сезон: сезона
компания: компания
выкуп: выкупа
спорт: спорт
председатель: председатель
проводить: проводит
полный: полное полный
событие: события
лига: лиги
случай: случаях
академия: академии академию
спёрс: спёрс
тейлор: тейлор
дивизион: дивизион дивизионе
источник: источник источники источников
юар: юар
ресурс: ресурсы
футбольный: футбольного футбольной футбольную футбольные футбольный футбольных
статья: статьи статью статья
прозвище: прозвища
южноафриканский: южноафриканский
скрытый: скрытые
служебный: служебные
соревнование: соревнование
условие: условий условия
версия: версия
выступать: выступает
кайзер: кайзер
главный: главный главным
перейти: перейти
англ: англ
связаться: свяжитесь
сеть: сетях
сделка: сделку
обсуждение: обсуждение обсуждения
архивировать: архивировано
владеть: владела
фонд: фонд
матч: матч матчи
мочь: могли могут можете
навигация: навигации навигация
воспитывать: воспитывать
шаблон: шаблон шаблонами
структура: структур
амстердам: амстердам
причина: причин
объявить: объявлено
октябрь: октябре октября
франшиза: франшизы
местный: местного местных
заглавный: заглавная
рекомендация: рекомендации
содержание: содержание
создание: создание
иметь: иметь
код: код
итог: итога итогам итогов
эфстатиу: эфстатиу
амстердамский: амстердамским амстердамского
удалять: удаляйте
тренер: тренер тренером
день: дней
джон: джона
авторитетный: авторитетные
именование: именования
какой: какое
часть: части
иэн: иэн
правка: правки
основать: основан основанные
нидерл: нидерл
совет: совет совета
год: года году
алфавит: алфавиту
русский: русский
пожертвовать: пожертвовать
восемь: восьми
свой: свои свой
место: место
язык: язык языках
переговоры: переговоров
некоммерческий: некоммерческой
правило: правилах
сообщество: сообщество
заявление: заявление
май: мая
ответственность: ответственности
игрок: игроков
персональный: персональные
отредактировать: отредактирована отредактировать
система: системе
вызвать: вызвало
отправиться: отправился
заниматься: занимается
аяксом: аяксом
ссылка: ссылка ссылки ссылок
обладатель: обладатель
сперс: сперс
сообщить: сообщить
клуб: клуб клуба клубом клубы
избранный: избранные
википедия: википедии википедия
лицензия: лицензии
рассмотрение: рассмотрения
предложить: предложенное
форма: форма
ещё: ещё
аякса: аякса
путём: путём
первый: первом первый
пожалуйста: пожалуйста
маккарти: маккарти
стать: стал статей
бенний: бенни
аргумент: аргументы
неопр: неопр
править: править
присоединиться: присоединиться
действовать: действовать
подробный: подробнее
декабрь: декабря
севено: севен
ошибка: ошибке
мур: мур
вернуться: вернулся
столкнуться: столкнулись
получить: получил получить
снять: снять
процесс: процессу
кук: куки
участие: участие
роба: роб
шон: шон
запись: запись
соглашение: соглашения
форум: форум
приобретение: приобретении
создать: создать
имя: имён
сайт: сайт сайты
печать: печати
постоянный: постоянная
шпор: шпоры
владислав: владислав
страна: страна страны
викидать: викиданных
история: историю история
подведение: подведения
достигнуть: достигла
основывать: основывайте
пространство: пространства
чифс: чифс
просрочить: просроченные
утверждение: утверждениями
недовольство: недовольство
знак: знак
достижение: достижения
сменить: сменил
начать: начал начать
сюда: сюда
скачать: скачать
вмещать: вмещающем
товарный: товарный
пояснение: пояснение
вклад: вклад
выбыть: выбыв
кубок: кубка
сведение: сведения
заявка: заявку
стадион: стадион стадионе
другой: других
доля: доли
контроль: контроль
уровень: уровня
название: название
июль: июля
сноска: сносок
два: двух
херич: херич
цитировать: цитировать
тщательный: тщательного
хватать: хватает
зарегистрировать: зарегистрированный
политика: политика
просмотр: просмотры
против: против
подать: подал
ребёнок: детей
недостаток: недостатков
проверять: проверяема
основный: основная
сторона: стороны
сентябрь: сентября
трансфер: трансферу
стадия: стадии
требовать: требующие
город: города
свежий: свежие
смотреть: см
справка: справка
новый: новые новым
пригласить: пригласил
элемент: элемент
поручить: поручено
читать: читать
мы: нами
текущий: текущие
аякс: аякс
образовать: образован
добавить: добавив
время: время
зритель: зрителей
мобильный: мобильная
энциклопедия: энциклопедии
доступный: доступен
тысяча: тысяч
учётный: учётную
короткий: короткий
тематический: тематические
викимедиа: викимедиа
использование: использования
африка: африке
случайный: случайная
удалить: удалена
национальный: национальной
завершить: завершить
старза: старз
ари: ари
категория: категории
бартлетта: бартлетт
информация: информация
завершать: завершающей
президент: президент
хотеть: хотели
отдельный: отдельных
вместимость: вместимость
предлагаться: предлагается
отказ: отказ
серб: серб
проект: проектах
сохранение: сохранением
свободный: свободной
указание: указанием
конфиденциальность: конфиденциальности
официальный: официальный
связанный: связанные
дата: дата
поведение: поведения
должный: должна
социальный: социальных
викисклад: викисклад
противодействие: противодействием
разработчик: разработчики
вид: виде
городской: городские
дополнительный: дополнительные
ассистент: ассистентом
это: это
последний: последний
который: которая
сыграть: сыграл
примечание: примечания
организация: организации
настоящий: настоящее
январь: января
конкретизация: конкретизации
воин: воины
статистика: статистика
переименовать: переименовать
