мы: нами
изображение: изображениями
результат: результаты
р: р
сложный: сложным
век: века веков
лик: лик
использовать: использующие
аламбон: аламбон
занимать: занимает
кулонь: кулонь
движение: движение
евро: евро
член: член
статья: статьи
энциклопедия: энциклопедии
читатьправитьправить: читатьправитьправить
департамент: департамент департамента
многократно: многократно
правкиновое: правкиновые
учитель: учитель
целое: целом
перейти: перейти
широта: ш
примечание: примечания
страницасодержаниеизбрать: страницасодержаниеизбранные
выборы: выборах выборов
алфавитукоммуна: алфавитукоммуны
николь: николь
партия: партии партия
навигация: навигации навигация
франция: франции франция
страница: страница страницы
период: период
санган: санган
википедия: википедии википедия
кантон: кантон кантона
отенг: отенг
статьятекущий: статьятекущие
год: года году
статьисообществофорумсправкасвежий: статьисообществофорумсправкасвежие
статистика: статистика статистики
печать: печати
эскалить: эскаль
великобритания: великобритания
пункт: пункты
андра: андр
индекс: индекс
французский: французских
земля: земли
политика: политика
присвоить: присвоил
хоукхёрстый: хоукхёрст
записьвойти: записьвойти
герб: герб
дополнительный: дополнительные
медиафайл: медиафайлы
объединение: объединение
окенган: окенган
балингем: балингем
фонд: фонд
поиск: поиск поиску
центр: центра центре
страницуполучить: страницуполучить
лилль: лилля
поддержка: поддержку
язык: языках
галерея: галерея
хозяйство: хозяйство
переходить: переходил
превратить: превратив
плотность: плотность
мэрия: мэрии мэрия
находиться: находится
просмотр: просмотры
англия: англия
население: население населения
болото: болота
ссылкасведение: ссылкасведения
архивный: архивная
линия: линии
действовать: действовать
гем: гем
отказ: отказ
событияпожертвовать: событияпожертвовать
карон: карон
победа: победу
генеральный: генерального
национальный: национального национальный
указание: указанием
викисклад: викискладе
численность: численности
городпро: городпро
викимедиа: викимедиа
фр: фр
свободный: свободной
некоммерческий: некоммерческой
шевалье: шевалье
содержание: содержание
страна: страна
база: база
букий: буко
персональный: персональные
местный: местный
условие: условий условия
также: также
мельница: мельница
дубль: дубле
январь: января
замок: замок
совет: совета
тур: туре
несколько: нескольких
рука: рук руки
авторство: авторства
лихтервельд: лихтервельде
правкипостоянный: правкипостоянная
материал: материал
отредактировать: отредактирована
ошибкекак: ошибкекак
коммуна: коммуна коммунах коммуны
часовой: часовой
депутат: депутат
среднегодовой: среднегодовой
имя: имя имён
расположить: расположена
поленок: поленков
короткий: короткий
представиться: представились
уровень: уровень
эрбенган: эрбенган
июнь: июня
пояс: пояс
бурсный: бурсен
учётный: учётную
народный: народное
альбер: альбер
этот: эта
фамилия: фамилия
столетие: столетий
республиканец: республиканцы
подробный: подробнее
разработчик: разработчики
знак: знак
союз: союз
отдельный: отдельных
договор: договору
пост: пост
использование: использования
динамика: динамика
викискладэлемент: викискладэлемент
населённый: населённые
станция: станция
торговля: торговля
брем: брем
демократ: демократов
экономика: экономика
фьенна: фьенн
протяжение: протяжении
список: список
транспорт: транспорт
апрель: апреля
позапозапрошлый: позапозапрошлом
сообщить: сообщить
кодистория: кодистория
бенган: бенган
связаться: свяжитесь
код: код
страницецитировать: страницецитировать
мэр: мэр мэра мэров
безработица: безработицы
правый: правый
вход: входом
статьяобсуждение: статьяобсуждение
окрестный: окрестные
ардр: ардр
достопримечательность: достопримечательности
данные: данных
ещё: ещё
зюткерк: зюткерк
она: ею
временной: временные
викидать: викиданных
рюменган: рюменган
мочь: могут
округ: округ округа
русский: русский
луш: луш
норткерк: норткерк
поселение: поселению
каффья: каффье
человек: человек человека
одрюик: одрюик одрюика
цифровой: цифровые
чел: чел
годувикипедия: годувикипедия
автомагистраль: автомагистрали
заглавный: заглавная
поведение: поведения
кук: куки
бодуэн: бодуэн
муниципальный: муниципальные муниципальных
занятость: занятости
викиданныхнп: викиданныхнп
святой: святого
диаграммывикипедия: диаграммывикипедия
доход: доход
история: история
перестроить: перестроил
модуль: модуль
свойство: свойство
км: км
промышленность: промышленность
последний: последний последняя
сфера: сфера
текст: текст
демография: демография
голос: голосов
заявление: заявление
регион: регион региона
мобильный: мобильная
править: править
сюдасвязанный: сюдасвязанные
государственный: государственные
кокель: кокель
ответственность: ответственности
копия: копия
кодекс: кодекс
версия: версия
фретен: фретен
структура: структура
категория: категории
лето: летом
инструмент: инструменты
служба: службы
начало: начала
системеобсуждениевкладсоздать: системеобсуждениевкладсоздать
марк: марк
кале: кале
карта: картами карты
церковь: церковь
республика: республики
стать: стал
нимвегенский: нимвегенскому
лицензия: лицензии
фландрский: фландрский
почтовый: почтовый
пространство: пространства
страницыслужебный: страницыслужебные
ссылка: ссылки
арденган: арденган
географический: географический
география: география
осушить: осушил
конфиденциальность: конфиденциальности
смотреть: см
пахотный: пахотные
м: м
идентификатор: идентификаторы
граф: граф
город: города
товарный: товарный
предприниматель: предприниматель
зарегистрировать: зарегистрированный
здание: здание
пёпленг: пёпленг
оффекерк: оффекерк
администрация: администрация
институт: институт
эрмеленган: эрмеленган
статьислучайный: статьислучайная
доступный: доступен
организация: организации
получить: получив
скачать: скачать
услуга: услуг
сангатт: сангатт
викиданныхвикипедия: викиданныхвикипедия
филипп: филипп
случай: случаях
площадь: площадь
возглавлять: возглавляемый
бельгия: бельгия
пока: пока
ветряный: ветряная
проект: проектах
роделенган: роделенган
гин: гин
собрание: собрания
сохранение: сохранением
статус: статус
описание: описание
участие: участие
железнодорожный: железнодорожная
другой: других
строительство: строительство
заполнить: заполнить
шато: шато
сельский: сельское
мартин: мартина
источник: источник источниками
высота: высота
правка: правка
часть: частью
одержать: одержал
