войти: войти
км: км
центр: центра
татарча: татарча
действовать: действовать
подробный: подробнее
статья: статьи статья
год: год года лет
ошибка: ошибке
часовой: часовой
население: население населения
силеса: силес
описание: описание
авторство: авторства
материал: материал
заглавный: заглавная
статус: статус
содержание: содержание
поиск: поиск поиску
внешний: внешние
м: м
город: города
правка: правка правки
обсуждение: обсуждение
чел: чел
муниципальный: муниципальный муниципальных
смотреть: см
свежий: свежие
кук: куки
графика: графики
код: код
график: графиками
последний: последний последняя
инструмент: инструменты
округ: округов
справка: справка
новый: новые
страница: страница странице страницу страницы
размер: размер
житель: жителей
гонсалес: гонсалес
испания: испании испания
участие: участие
элемент: элемент
широта: ш
район: район района
библиографический: библиографических
условие: условий условия
исп: исп
муниципалитет: муниципалитет муниципалитеты
читать: читать
запись: запись
институт: институт
форум: форум
мы: нами
реестр: реестр
википедия: википедии википедия
представиться: представились
этот: эта
герб: герб
численность: численности численность
текущий: текущие
провинция: провинции провинцию провинция
ноябрь: ноября
создать: создать
список: список
нохчийна: нохчийн
имя: имён
статистика: статистика статистики
источник: источник источниками
текст: текст
кодекс: кодекс
история: история
печать: печати
хаэн: хаэн хаэна
постоянный: постоянная
страна: страна
викисклад: викисклад викискладе
мобильный: мобильная
викидать: викиданных
алфавит: алфавиту
медиафайл: медиафайлы
энциклопедия: энциклопедии
пространство: пространства
символ: символов
русский: русский
пожертвовать: пожертвовать
орнос: орнос
доступный: доступен
почтовый: почтовый
знак: знак
язык: языках
некоммерческий: некоммерческой
человек: человека
бенатаэ: бенатаэ
учётный: учётную
событие: события
комарка: комарки
получить: получить
пункт: пункты
короткий: короткий
официальный: официальная
сообщество: сообщества сообщество
морсильо: морсильо
случай: случаях
сюда: сюда
словарь: словари
карта: картами карты
скачать: скачать
товарный: товарный
викимедиа: викимедиа
ответственность: ответственности
вклад: вклад
использование: использования
площадь: площадь
персональный: персональные
случайный: случайная
каталог: каталогах
отредактировать: отредактирована
находиться: находится
ресурс: ресурсы
география: география
система: системе
недоступный: недоступны
три: трёх
ссылка: ссылка ссылки
телефонный: телефонный
категория: категории
скрытый: скрытые
сведение: сведения
населённый: населённые
нп: нп
служебный: служебные
лето: летом
другой: других
сообщить: сообщить
версия: версия
национальный: национальный
автомобильный: автомобильный
пояс: пояс
избранный: избранные
индекс: индекс
занимать: занимает
отдельный: отдельных
навигация: навигации навигация
автономный: автономного автономное
лицензия: лицензии
высота: высота
отказ: отказ
проект: проектах
название: название
перейти: перейти
расстояние: расстояние
сохранение: сохранением
свободный: свободной
идентификатор: идентификаторы
андалусие: андалусия
указание: указанием
заявление: заявление
конфиденциальность: конфиденциальности
связанный: связанные
каталанский: каталанская
ещё: ещё
связаться: свяжитесь
поведение: поведения
разработчик: разработчики
информация: информацию
дополнительный: дополнительные
фабрикатор: фабрикаторе
мэр: мэр
входить: входит
административный: административного
цитировать: цитировать
орсера: орсера
примечание: примечания
вд: вд
организация: организации
цифровой: цифровые
состав: составе
паскуаля: паскуаль
технический: технических
менее: менее
проблема: проблем
зарегистрировать: зарегистрированный
фонд: фонд
политика: политика
больший: большая
вильярродриго: вильярродриго
просмотр: просмотры
мочь: могут
хенава: хенаве
править: править
