халаджи: халаджи
войти: войти
составлять: составляет
число: число
описание: описание
диаспора: диаспора диаспорой диаспоры
авторство: авторства
материал: материал
оралман: оралманов оралманы
язык: язык языках языке языком
переезжать: переезжают
поиск: поиск поиску
мост: мостов
первый: первая первую
группа: группа группу
инструмент: инструменты
получать: получают
иран: иран ирана иране
страница: страница странице страницу страницы
значительно: значительно
обращение: обращения
остан: остана
голестан: голестан голестане
алматинский: алматинской
район: районе
выше: выше
представиться: представились
область: области
современный: современном современные
младший: младший
ноябрь: ноября
текст: текст
кодекс: кодекс
казах: казахи казахов
иранский: иранские иранских иранского
волгоград: волгоград
тюрк: тюрки
радиопрограмма: радиопрограмма
два: две
тат: таты
постепенно: постепенно
указать: указан указано
выходить: выходить
северный: северной
кашкаец: кашкайцы
туркмен: туркменами туркмены
кыргызстан: кыргызстан
скрытый: скрытая
событие: события
исламский: исламской
турция: турция
связь: связи
программа: программе программой
случай: случаях
казахский: казахская казахские казахский казахских казахское казахском
отличаться: отличаться
православие: православие
традиция: традиции
казахстан: казахстан казахстане
россия: россия
статья: статьи статья
русский: русский русским
служебный: служебные
афганистан: афганистан афганистана
условие: условий условия
версия: версии версия
полукочевой: полукочевые
перейти: перейти
млн: млн
средний: средний
туркмения: туркмении
связаться: свяжитесь
культурный: культурный
образование: образование
правка: правки правок
проживать: проживало проживают проживающими
актау: актау
народный: народная народные
архивировать: архивировано
газета: газет
менее: менее
март: марта
фонд: фонд
мочь: могут
мангистауска: мангистауской
навигация: навигации навигация
украина: украина
понимать: понимают
относительно: относительно
население: население
осень: осенью
письменность: письменность
канада: канада
заглавный: заглавная
туркменистан: туркменистан
содержание: содержание
февраль: февраля
общий: общее общей
жуза: жузы
код: код
племя: племена
школа: школ
такой: таких
бабык: бабык
территория: территории территорию
этот: эта
часть: части часть частью
кухня: кухня
белуджи: белуджи
татарин: татары
год: года годах году годы
неотъемлемый: неотъемлемой
численность: численность численностью
прибыть: прибывших прибыла
октябрьский: октябрьской
пожертвовать: пожертвовать
тюркский: тюркские тюркской
ислам: ислам
отношение: отношение
разместить: разместили
город: городах
систанийский: систанийские
тюркпена: тюркпен
беженец: беженцев
чехармехальский: чехармехальские
некоммерческий: некоммерческой
большинство: большинстве большинство
который: которую
тегеран: тегеране
сообщество: сообщество
заявление: заявление
чараймак: чараймаки
май: мая
ответственность: ответственности
персональный: персональные
отредактировать: отредактирована
литература: литература
саратов: саратов
различный: различные
система: системе
расселиться: расселились
проверка: проверки
ссылка: ссылка ссылки
многие: многие
человек: человек
один: одним
сообщить: сообщить
избранный: избранные
википедия: википедии википедия
илийский: илийском
треть: трети
проверить: проверенной
лицензия: лицензии
иммигрировать: иммигрировали
старший: старший
практически: практически
являться: являются
ещё: ещё
черкес: черкесы
волна: волна
свой: своих своём
узбекистан: узбекистан
больший: большая
вновь: вновь
неопр: неопр
течение: течением
омск: омск
править: править
служить: служить
действовать: действовать
подробный: подробнее
война: войне
семья: семей семьи
ошибка: ошибке
фарси: фарси
обсуждение: обсуждение
кук: куки
армянин: армяне
участие: участие
араб: арабы
молодой: молодой
горган: горган
знать: знают
запись: запись
крупный: крупных
форум: форум
курд: курды
создать: создать
имя: имён
тот: той
жуз: жуз
пуштун: пуштуны
качество: качестве
печать: печати
автономия: автономии
персидский: персидские персидском
постоянный: постоянная
тойжан: тойжан
стать: стала
викидать: викиданных
доказать: доказали
европа: европа
самара: самара
детский: детская детский
основное: основном
сша: сша
пространство: пространства
бахтиара: бахтиары
лур: луры
грузин: грузины
знак: знак
частично: частично
квартал: кварталы
получить: получить
товарный: товарный
сюда: сюда
правило: правило
скачать: скачать
вклад: вклад
челябинск: челябинск
требовать: требовали требуют
талыш: талыши
туркменсахра: туркменсахра
репатриироваться: репатриировалось
ассириец: ассирийцы
опытный: опытными
ру: ру
представитель: представитель
хорасанский: хорасанские
появиться: появилось
сведение: сведения
синд: синды
другой: других
пытаться: пытаются
английский: английский
алтай: алтай
следующий: следующая
утрачивать: утрачивают
июнь: июня
июль: июля
общество: общества
компенсировать: компенсировали
народ: народов народы
цитировать: цитировать
связующий: связующих
поэзия: поэзия
интеграция: интеграцию
зарегистрировать: зарегистрированный
политика: политика
лак: лаки
просмотр: просмотры
азербайджанец: азербайджанцы
пять: пяти
селиться: селились
затруднять: затрудняет
танец: танцы
десяток: десятков
сентябрь: сентября
участник: участниками
свежий: свежие
смотреть: см
справка: справка
новый: новые
монголия: монголия
астрахань: астрахань
проводить: проводимой
проверяться: проверялась
элемент: элемент
религия: религии религия
оседлый: оседлые
время: времени время
читать: читать
мы: нами
изучать: изучают
коллективизация: коллективизации
регион: региона
текущий: текущая текущие
владеть: владеют
история: история
около: около
афшара: афшары
тюмень: тюмень
мобильный: мобильная
музыка: музыка
энциклопедия: энциклопедии
репатриация: репатриации
китай: китай
сокращаться: сокращается
перс: персы
открыть: открыть
доступный: доступен
иностранный: иностранного
центр: центр
ежедневный: ежедневная
источник: источник
тысяча: тысяч
оренбург: оренбург
учётный: учётную
категория: категории категория
короткий: короткий
махаллях: махаллях
викимедиа: викимедиа
рядом: рядом
мешхед: мешхеде
использование: использования
случайный: случайная
отток: отток
революция: революции
кочевой: кочевые
пока: пока
культура: культура
пройти: пройдя
беларускать: беларуская
отдельный: отдельных
многочисленный: многочисленными
отказ: отказ
проект: проектах
еврей: евреи
хазареец: хазарейцы
сохранение: сохранением
свободный: свободной
указание: указанием
конфиденциальность: конфиденциальности
связанный: связанные
дата: дата
журнал: журналов
поведение: поведения
страна: страны
таджик: таджики
гилянец: гилянцы
одночасовой: одночасовая
разработчик: разработчики
панджабец: панджабцы
несколько: несколько
узбек: узбеки
дополнительный: дополнительные
мазендеранец: мазендеранцы
происхождение: происхождение
туркменский: туркменский
последний: последний
мангышлак: мангышлака
примечание: примечания
организация: организации
официальный: официальных
однако: однако
фольклор: фольклор
статистика: статистика
