край: край краю края
административный: административные административный административных
мы: нами
отказ: отказ
событияпожертвовать: событияпожертвовать
системеобсуждениевкладсоздать: системеобсуждениевкладсоздать
россия: россии россия
район: район района районе районов
язык: языка языках
ларичихинский: ларичихинский
перепись: переписи
единица: единица единицах единице единицы
карточкепро: карточкепро
анисимовский: анисимовский
глава: глава
акт: акты
населить: населённый населённым населённых
сообщить: сообщить
число: числе
муниципальный: муниципального муниципальное муниципальные муниципальным муниципальных
алтайский: алтайский алтайского алтайскому
городской: городских городского городское
деление: деления
лицензия: лицензии
кодистория: кодистория
связаться: свяжитесь
указание: указанием
федеральный: федеральная федеральный федеральных
женщина: женщин
пространство: пространства
код: код
страницецитировать: страницецитировать
нормативный: нормативные
образовать: образовано
министерство: министерство
численность: численности численность
озёрский: озёрский
лушниковский: лушниковский
показатель: показателей
наделение: наделении
владимир: владимир
сельский: сельские сельским сельских сельского сельское
страница: страница страницы
викимедиа: викимедиа
свободный: свободной
недоступный: недоступная
страницыслужебный: страницыслужебные
статья: статьи
ссылка: ссылка ссылки
энциклопедия: энциклопедии
читатьправитьправить: читатьправитьправить
некоммерческий: некоммерческой
росстат: росстат
статьяобсуждение: статьяобсуждение
курочкинский: курочкинский
центр: центр
данные: данным данных
привести: приведённых
декабрь: декабря
страна: страна
база: база
площадь: площади площадь
ещё: ещё
конфиденциальность: конфиденциальности
учёт: учёта
правкиновое: правкиновые
юстиция: юстиции
нерабочий: нерабочими
позапрошлый: позапрошлом
поселение: поселение поселений поселения
смотреть: см
автоматически: автоматически
рассчитать: рассчитана
новоозёрский: новоозёрский
состав: состав
викидать: викиданных
персональный: персональные
пункт: пункт пунктам пунктов пункты
образование: образование образований образования образованиям
закон: закон
перейти: перейти
окато: окато
мочь: могут
русский: русский
условие: условий условия
правовой: правовые
тальменский: тальменский тальменского тальменском
примечание: примечания
страницасодержаниеизбрать: страницасодержаниеизбранные
дополнить: дополнив
шишкинский: шишкинский
статус: статус статусом
устройство: устройстве
поссовет: поссовет
навигация: навигации навигация
субъект: субъект субъектов
среднесибирский: среднесибирский
январь: января
государственный: государственной
таблица: таблица
элемент: элемент
население: население населения
помочь: помогите
товарный: товарный
чел: чел
авторство: авторства
служба: служба
зарегистрировать: зарегистрированный
оценка: оценка
краямуниципальный: краямуниципальные
википедия: википедии википедия
новоперуновский: новоперуновский
округ: округа округов
материал: материал
октмый: октмо
заготовка: заготовка
год: гг год года
её: её
характеристика: характеристика
сельсовет: сельсовет
шадринцевский: шадринцевский
статьятекущий: статьятекущие
статьисообществофорумсправкасвежий: статьисообществофорумсправкасвежие
поведение: поведения
новотроицкий: новотроицкий
ссылкамивикипедия: ссылкамивикипедия
кук: куки
мужчина: мужчин
статистика: статистика статистики
текущий: текущего
эрмиша: эрмиш
ошибкекак: ошибкекак
печать: печати
человек: человека
отредактировать: отредактирована
часовой: часовой
установление: установлении
кашкарагаихинский: кашкарагаихинский
луговской: луговской
результат: результатам
атд: атд
политика: политика
граница: границ
районаскрыть: районаскрытые
последний: последний последняя
статьислучайный: статьислучайная
имя: имён
записьвойти: записьвойти
алфавитусельский: алфавитусельские
доступный: доступен
дополнительный: дополнительные
архивировать: архивировано
яковлевич: яковлевич
организация: организации
составить: составила
казанцевский: казанцевский
посёлок: посёлок
короткий: короткий
скачать: скачать
викиданныхвикипедия: викиданныхвикипедия
представиться: представились
зайцевский: зайцевский
случай: случаях
среднее: среднем
правкипостоянный: правкипостоянная
текст: текст
похозяйственный: похозяйственного
пояс: пояс
фонд: фонд
учётный: учётную
проект: проектах
заглавный: заглавная
российский: российской
это: это
автопростановка: автопростановкой
этот: эта
итог: итоги
размещение: размещение
поиск: поиск поиску
заявление: заявление
страницуполучить: страницуполучить
сохранение: сохранением
мобильный: мобильная
править: править
подробный: подробнее
федерация: федерации
разработчик: разработчики
речкуновский: речкуновский
знак: знак
сведение: сведений
описание: описание
сюдасвязанный: сюдасвязанные
отдельный: отдельных
участие: участие
ноябрь: ноября
староперуновский: староперуновский
постоянный: постоянного
другой: других
использование: использования
ответственность: ответственности
всероссийский: всероссийской
входить: входит
плотность: плотность
март: марта
просмотр: просмотры
кодекс: кодекс
версия: версия
годунезавершённый: годунезавершённые
категория: категории
населённый: населённые
ссылкасведение: ссылкасведения
май: мая
источник: источник источниками
инструмент: инструменты
правка: правка
основа: основе
действовать: действовать
