мы: нами
нанести: нанесён
отказ: отказ
бэйрдом: бэйрдом
событияпожертвовать: событияпожертвовать
системеобсуждениевкладсоздать: системеобсуждениевкладсоздать
язык: язык языках
данный: данном данный
карта: картами
взойти: взошли
восхождение: восхождение восхождения
асгардангл: асгардангл
сообщить: сообщить
июль: июле
год: года году
любить: любил
длина: длина
камера: камеру
гора: гора горой горы
лицензия: лицензии
кодистория: кодистория
покорить: покорён
связаться: свяжитесь
оставаться: остаётся
использовать: использующие
совершить: совершено совершил
указание: указанием
текущий: текущем
содружество: содружества
пространство: пространства
викисклад: викискладе
популярный: популярным
маршрут: маршрутов маршрутом
код: код
территориянунать: территориянунавут
оригинал: оригинала
алфавитупро: алфавитупро
страницецитировать: страницецитировать
минимум: минимум
парашют: парашютом
викимедиа: викимедиа
мифология: мифологии
землягорный: землягорные
страница: страница страницы
свободный: свободной
формат: формат
страницыслужебный: страницыслужебные
ссылка: ссылки
исправить: исправить
камисава: камисавой
энциклопедия: энциклопедии
читатьправитьправить: читатьправитьправить
волшебный: волшебные
алфавитугорный: алфавитугорные
некоммерческий: некоммерческой
статьяобсуждение: статьяобсуждение
высокий: высоких высшая
опора: опоры
кадр: кадров
назвать: названа
уровень: уровнем
варьировать: варьирует
рётлисбергер: рётлисбергером
ещё: ещё
страна: страна
конфиденциальность: конфиденциальности
правкиновое: правкиновые
путь: путь
объект: объекты
сделать: сделано
смотреть: см
кордильеры: кордильеры
викидать: викиданных
расположение: расположение
персональный: персональные
указать: указан
перейти: перейти
известный: известная
широта: ш
сторона: стороне
пик: пик пика пиками
северный: северной северную северный
месяцевикипедия: месяцевикипедия
русский: русский
мочь: могут
разделить: разделёнными
примечание: примечания
условие: условий условия
страницасодержаниеизбрать: страницасодержаниеизбранные
море: моря
м: м
форма: формы
тот: тех
устаревший: устаревший
навигация: навигации навигация
южный: южную южный
январь: января
кордильерыскрыть: кордильерыскрытые
первый: первое первый
искусственный: искусственных
плоский: плоские
класс: класс
город: города
товарный: товарный
пэвуром: пэвуром
массивбаффин: массивбаффин
авторство: авторства
зарегистрировать: зарегистрированный
значение: значения
точка: точек точка
википедия: википедии википедия
считаться: считается
большинство: большинство
заглавный: заглавная
правкипостоянный: правкипостоянная
материал: материал
дата: дата
географический: географические
скалолазный: скалолазных
статьятекущий: статьятекущие
статьисообществофорумсправкасвежий: статьисообществофорумсправкасвежие
поведение: поведения
кук: куки
другой: другие других
метр: метров
канадыарктический: канадыарктические
отредактировать: отредактирована
фильм: фильма
горный: горная горные
ошибкекак: ошибкекак
печать: печати
дж: дж
уэбер: уэбером
создание: создания
политика: политика
небесный: небесного
гео: гео
мобильный: мобильная
последний: последний последняя
статьислучайный: статьислучайная
рик: рик
статистика: статистика
открывать: открывающих
записьвойти: записьвойти
имя: имён
седловина: седловиной
доступный: доступен
дополнительный: дополнительные
восточный: восточной
архивировать: архивировано
медиафайл: медиафайлы
организация: организации
земля: земля
соответственно: соответственно
август: августа
умелый: умелого
короткий: короткий
хребет: хребет
скачать: скачать
системаарктический: системаарктические
представиться: представились
шпион: шпион
случай: случаях
асгарда: асгард
текст: текст
цилиндрический: цилиндрической
фонд: фонд
учётный: учётную
проект: проектах
высота: высота высоте
это: это
баффиновый: баффинова
этот: эта
честь: честь
вуд: вудом
котать: кочем
поиск: поиск поиску
заявление: заявление
страницуполучить: страницуполучить
оба: оба
абсолютный: абсолютная
иметь: имеет
англ: англ
остров: острове
сохранение: сохранением
второй: второй
обращение: обращения
править: править
подробный: подробнее
канада: канада
разработчик: разработчики
знак: знак
флаг: флаг
описание: описание
сюдасвязанный: сюдасвязанные
отдельный: отдельных
координатприродный: координатприродные
участие: участие
себя: собой
обитель: обители
ноябрь: ноября
навык: навыков
использование: использования
ответственность: ответственности
термин: термина
геокаре: геокаре
распространить: распространённым
асгардасгард: асгардасгард
клэнка: клэнки
проложить: проложено
март: марта
который: который
двухтысячникибаффинов: двухтысячникибаффинова
просмотр: просмотры
кодекс: кодекс
пора: пор
версия: версия
два: двумя
сильвестер: сильвестер
существовать: существуют
самый: самым
вершина: вершины
категория: категории
викискладэлемент: викискладэлемент
ссылкасведение: ссылкасведения
требовать: требуют
марметом: марметом
источник: источник
инструмент: инструменты
правка: правка
британский: британского
действовать: действовать
представлять: представляют
