язык: языка языках
войти: войти
бретон: бретон
харбур: харбур
действовать: действовать
подробный: подробнее
статистический: статистическая статистическое
статья: статьи статья
год: год года годам году
неорганизованный: неорганизованные
ошибка: ошибке
население: население населения
демография: демография
количество: количество
описание: описание
авторство: авторства
материал: материал
перепись: переписи перепись
атд: атд
далее: д
позапозапрошлый: позапозапрошлом
участник: участниками
канада: канада канады
лишь: лишь
заглавный: заглавная
народ: народов
содержание: содержание
поиск: поиск поиску
город: города
правка: правка правки
обсуждение: обсуждение
чел: чел
побережье: побережье
свежий: свежие
смотреть: см
кук: куки
код: код
последний: последняя
инструмент: инструменты
баскуес: баскуес
справка: справка
дать: данная
новый: новые
страница: страница странице страницы
проверяться: проверялась
поселение: поселения
переписной: переписного переписное переписной переписному переписные
участие: участие
община: общины
ренкорт: ренкорте
элемент: элемент
обращение: обращения
сента: сент
широта: ш
район: район района району районы
условие: условий условия
ньюфаундленд: ньюфаундленд ньюфаундленда
больший: большей
читать: читать
запись: запись
форум: форум
мортс: мортс
мы: нами
википедия: википедии википедия
представиться: представились
текущий: текущие
территория: территория
часть: части
создать: создать
карточка: карточке
имя: имён
статистика: статистика статистики
текст: текст
кодекс: кодекс
остров: острова
сила: сил
история: история
печать: печати
бэй: бэй
расположить: расположен
соответствующий: соответствующими
страна: страна
мобильный: мобильная
викидать: викиданных
алфавит: алфавиту
численность: численность
данные: данным
энциклопедия: энциклопедии
пространство: пространства
политический: политическим
русский: русский
пожертвовать: пожертвовать
доступный: доступен
самиаджия: самиаджий
знак: знак
источник: источник источники
пулс: пулс
некоммерческий: некоммерческой
учётный: учётную
событие: события
лабрадор: лабрадор лабрадора
получить: получить
роза: роз
отличие: отличие
короткий: короткий
право: правами
сообщество: сообщество
заявление: заявление
случай: случаях
сюда: сюда
скачать: скачать
товарный: товарный
бурнт: бурнт
карта: картами
викимедиа: викимедиа
провинция: провинции провинций
май: мая
ответственность: ответственности
вклад: вклад
ле: ле
использование: использования
площадь: площадь
персональный: персональные
миаупукек: миаупукек
случайный: случайная
подрайон: подрайон
система: системе
существовать: существуют
айландс: айландс
ссылка: ссылки
категория: категории
скрытый: скрытые
сведение: сведения
эспоир: эспоир
человек: человек
служебный: служебные
служба: служба
другой: других
сообщить: сообщить
коренной: коренных
версия: версия
сейнт: сейнт
автопростановка: автопростановкой
избранный: избранные
моррисвилла: моррисвилл
некоторый: некоторых
составлять: составляла составляло
аукс: аукс
отдельный: отдельных
административный: административные
образование: образованием
лицензия: лицензии
отказ: отказ
проект: проектах
июнь: июня
оф: оф
перейти: перейти
сохранение: сохранением
свободный: свободной
англ: англ
исл: исл
ковы: ков
являться: являются
бургео: бургео
указание: указанием
конфиденциальность: конфиденциальности
связанный: связанные
навигация: навигации навигация
дата: дата
истый: ист
ещё: ещё
связаться: свяжитесь
поведение: поведения
единица: единицы
подразделение: подразделение
коу: коу
деление: деление
разработчик: разработчики
дополнительный: дополнительные
южный: южном
архивировать: архивировано
примечание: примечания
организация: организации
август: августа
албанс: албанс
январь: января
зарегистрировать: зарегистрированный
фонд: фонд
политика: политика
рамеа: рамеа
мочь: могут
гаультойс: гаультойс
просмотр: просмотры
беллеор: беллеорам
править: править
