войти: войти
составлять: составляет составляли
высоковый: высоково
глобеново: глобеново
многоснежный: многоснежной
количество: количество
контеево: контеево
авторство: авторства
описание: описание
федеральный: федеральный
трофимовый: трофимово
материал: материал
щелыковый: щелыково
княгинино: княгинино
поиск: поиск поиску
рогозка: рогозки
ососовый: ососово
дьяконка: дьяконка
колотиловый: колотилово
инструмент: инструменты
афонасковый: афонасково
берег: берегу
аргунок: аргунка
южный: южной
страница: страница странице страницу страницы
район: район района районе районов
дмитриевый: дмитриево
новосёлка: новосёлки
новографский: новографское
обращение: обращения
пургасовый: пургасово
иваньковый: иваньково
княжевый: княжево
выше: выше
пакшиный: пакшино
тип: тип
куприяновый: куприяново
золотунино: золотунино
представиться: представились
область: области область
кисляковый: кисляково
боярский: боярское
емельяновый: емельяново
каплиный: каплино
корёга: корёга
леоново: леоново
километр: километров
текст: текст
кодекс: кодекс
бараново: бараново
умеренно: умеренно
вакорино: вакорино
указать: указан
малавино: малавино
апрель: апреля
казариновый: казариново
дъяконовый: дъяконово
горлово: горлово
лужок: лужок
бродня: бродни
чадов: чадово
тимофеево: тимофеево
россия: россии россия
овсяниковый: овсяниково
полеталовый: полеталово
событие: события
боковый: боково
пигалицино: пигалицино
короткий: короткий коротким
природный: природных
пункт: пунктов пункты
ивонино: ивонино
гавриловский: гавриловское
случай: случаях
карта: картами карты
кирьяковый: кирьяково
левый: левом
максимум: максимум
схема: схема
бендино: бендино
калинино: калинино
структура: структуре
ваневый: ванево
результат: результатам
ананьиный: ананьино
статья: статьи статья
среднегодовой: среднегодовая
покров: покров
скрытый: скрытые
андреевский: андреевское
население: население населения
служебный: служебные
безморозный: безморозный
октмый: октмо
буйский: буйский буйского буйском
атмосферный: атмосферных
условие: условий условия
версия: версия
перечень: перечня
лошниковый: лошниково
индекс: индекс
копия: копии
г: г
расстояние: расстоянии
приказ: приказ
который: которых
юрецкий: юрецкие
пироговый: пирогово
перейти: перейти
тимошкино: тимошкино
идентификатор: идентификаторы
продолжительность: продолжительность
связаться: свяжитесь
гускино: гускино
федорковый: федорково
административный: административного
течение: течение
архивировать: архивировано
ягилевый: ягилево
март: марта
фонд: фонд
администрация: администрации
холодное: холодного
мочь: могут
внуково: внуково
починка: починок
навигация: навигации навигация
костромской: костромская костромской
молога: молога
состав: состав
центральный: центрального центральное центральный
период: период периода
счастливый: счастливое
постановление: постановление
трухино: трухино
относительно: относительно
мешковый: мешково
игумново: игумново
муниципальный: муниципального муниципальный
елегино: елегино
заглавный: заглавная
куребрино: куребрино
содержание: содержание
м: м
гагариный: гагарино
русиново: русиново
код: код
калинкин: калинкино
московский: московское
лесорастительный: лесорастительных
поселение: поселение поселения
недоступный: недоступная недоступные
широта: ш
дмитриковый: дмитриково
значение: значения
шульгино: шульгино
талица: талица
шач: шачи
день: дней
год: года годов году
этот: эта
шумовица: шумовица
горка: горка
карповский: карповское
часть: части
воскресение: воскресенье
соколово: соколово
село: село
населить: населённых
митяево: митяево
перепись: переписи
правка: правка правки
слободка: слободка
иванищево: иванищево
источник: источник источниками
подзона: подзоне
елиный: елино
нагорный: нагорное
костиново: костиново
холодный: холодной
кокотово: кокотово
ресурс: ресурсов
будущево: будущево
вертуново: вертуново
пилатовый: пилатово
алфавит: алфавиту
численность: численность
матвеево: матвеево
мельниковый: мельниково
малый: малое
федерация: федерации
телешовый: телешово
русский: русские русский
пожертвовать: пожертвовать
дора: дор
мягковый: мягково
язык: язык языках
ильинский: ильинское
некоммерческий: некоммерческой
снежный: снежный
сообщество: сообщество
заявление: заявление
май: мая
ответственность: ответственности
утверждение: утверждении
персональный: персональные
зона: зон зоне
толстиковый: толстиково
отредактировать: отредактирована
минимум: минимум
география: география
система: системе
применять: применяемого
ссылка: ссылка ссылки
поповка: поповка
мизрино: мизрино
западный: западной
ваганово: ваганово
растение: растений
человек: человек
населённый: населённые
барыковый: барыково
нп: нп
казаковый: казаково
смольница: смольница
ермолин: ермолино
сообщить: сообщить
субъект: субъект
пояс: пояс
бора: боры
википедия: википедии википедия
избранный: избранные
старостино: старостино
токарево: токарево
климат: климат
лицензия: лицензии
паршутиный: паршутино
брызгаловый: брызгалово
смещение: смещение
носковый: носково
ноздрино: ноздрино
ещё: ещё
тюшковый: тюшково
примерно: примерно
кострома: кострома
алешковый: алешково
рябцовый: рябцово
прибытковый: прибытково
слон: слон
вегетация: вегетации
цифровой: цифровые
мм: мм
царёв: царево
неопр: неопр
править: править
коныгино: коныгино
васятино: васятино
холодиловый: холодилово
натальин: натальино
км: км
действовать: действовать
подробный: подробнее
ошибка: ошибке
часовой: часовой
угольский: угольское
исчисление: исчислении
месяц: месяца
камешек: камешки
статус: статус
борисиковый: борисиково
база: база
море: моря
обсуждение: обсуждение
шушкод: шушкодом
кук: куки
власовый: власово
фролово: фролово
последний: последний последняя
реестр: реестра
сокольниковый: сокольниково
гусёвый: гусево
кошкарово: кошкарово
участие: участие
всероссийский: всероссийские
харневый: харнево
запись: запись
характеризоваться: характеризуется
форум: форум
министерство: министерства
выездново: выездново
новинка: новинки
ястрёбово: ястребово
согласно: согласно
семёновский: семёновское
махровый: махрово
косинский: косинское
создать: создать
захарово: захарово
нохчийна: нохчийн
имя: имён
липятино: липятино
архивный: архивной
буй: буй
груздёвый: груздево
пилятино: пилятино
пустыня: пустыня
печать: печати
постоянный: постоянная
горшковый: горшково
тёплый: тёплого тёплым
логиново: логиново
страна: страна
молочный: молочное
метр: метра
викидать: викиданных
ивановский: ивановское
закон: закон
воробьёвый: воробьёво
пространство: пространства
приблизительно: приблизительно
спасти: спас
михеево: михеево
знак: знак
еретиковый: еретиково
дмитриевский: дмитриевское
кринка: кринки
октябрь: октябрь
получить: получить
посёлок: посёлок
жуйкино: жуйкино
упыревка: упыревка
продолжительный: продолжительной
товарный: товарный
сюда: сюда
скачать: скачать
макарий: макарий
щепино: щепино
вклад: вклад
семейкино: семейкино
сайт: сайт
ушаковый: ушаково
тайга: тайги
кренёвый: кренёво
колодино: колодино
длиться: длится
куриловый: курилово
сведение: сведения
конищево: конищево
ощепковый: ощепково
вахрушево: вахрушево
печенга: печенга
другой: другие других
кузнецовый: кузнецово
яковлевский: яковлевское
борок: борок
боровский: боровский
каплинский: каплинский
июнь: июня
годовой: годовое
сельский: сельского сельское
русый: рус
сравнительно: сравнительно
мальгино: мальгино
вторк: вторка
июль: июля
разъезд: разъезд
абсолютный: абсолютная абсолютный
григорьев: григорьево
держаться: держится
хорошево: хорошево
бариново: бариново
цитировать: цитировать
бартеневый: бартенево
континентальный: континентальный
весь: вся
плещеево: плещеево
ожоговый: ожогово
зарегистрировать: зарегистрированный
политика: политика
ликург: ликурга
окато: окато
данные: данных
нижний: нижнее
просмотр: просмотры
позапрошлый: позапрошлом
потаповый: потапово
центр: центр центра
благоноговый: благоногово
мыс: мыс
дубровка: дубровки
дудоровый: дудорово
сентябрь: сентября
гульбино: гульбино
город: города
чел: чел
обиженово: обиженово
смотреть: см
свежий: свежие
вантино: вантино
васильевский: васильевское
чистый: чистые
узковый: узково
справка: справка
планирование: планирования
новый: новые
романцевый: романцево
москва: москва
прямой: прямой
деревня: деревня
элемент: элемент
районный: районный
панин: панино
время: времени время
читать: читать
возвышенность: возвышенности
мы: нами
куриловский: куриловский
текущий: текущие
маслово: маслово
сам: самого
топоним: топонима
история: история
около: около
лесной: лесных
добрецовый: добрецово
дмитриевка: дмитриевка
мобильный: мобильная
большой: большое большой
гэс: гэс
энциклопедия: энциклопедии
матвейковый: матвейково
лытавино: лытавино
деньговый: деньгово
доступный: доступен
почтовый: почтовый
башмаковый: башмаково
анциферовый: анциферово
афонино: афонино
тетерин: тетерино
ферапонт: ферапонт
каменка: каменка
учётный: учётную
температура: температура
территориальный: территориального
лобановка: лобановка
васютин: васютино
викимедиа: викимедиа
река: реки
саловский: саловское
пурковый: пурково
хореново: хореново
использование: использования
случайный: случайная
находиться: находится
заломаев: заломаево
активный: активной
национальный: национальной национальный
зимой: зимой
деньговскай: деньговская
категория: категории
семёнковый: семёнково
барашковый: барашково
кусакино: кусакино
лето: летом
глебовский: глебовское
чумсаново: чумсаново
предел: пределах
мск: мск
пескотнево: пескотнево
сафоново: сафоново
отдельный: отдельных
высота: высота
отказ: отказ
проект: проектах
сохранение: сохранением
свободный: свободной
указание: указанием
конфиденциальность: конфиденциальности
официальный: официальный
станция: станции
куницино: куницино
связанный: связанные
дата: дата
поведение: поведения
ногавицын: ногавицыно
разработчик: разработчики
стефаново: стефаново
дополнительный: дополнительные
воздух: воздуха
холм: холм
галкино: галкино
входить: входит
ильин: ильино
павловский: павловское
изображение: изображений
коряк: коряков
вятка: вятка
примечание: примечания
организация: организации
уровень: уровнем
российский: российской
обуховый: обухово
январь: января
федотовый: федотово
лоходомовый: лоходомово
средний: средняя
осадки: осадков
выпадать: выпадает
статистика: статистика
