мы: нами
словосочетание: словосочетания
название: названия
отказ: отказ
пожалуйста: пожалуйста
системеобсуждениевкладсоздать: системеобсуждениевкладсоздать
событияпожертвовать: событияпожертвовать
ресторанный: ресторанный
апрель: апреля
спорт: спорта
категория: категория
сообщить: сообщить
вид: видах
писатель: писатель
энзый: энзо
лицензия: лицензии
кодистория: кодистория
связаться: свяжитесь
указание: указанием
начало: начале
женщина: женщин
пространство: пространства
код: код
страницецитировать: страницецитировать
указывать: указывала
олимпийский: олимпийских
участвовать: участвовать
викимедиа: викимедиа
сюда: сюда
дариюс: дариюс
алфавит: алфавиту
страница: страница страницы
академия: академии
свободный: свободной
страницыслужебный: страницыслужебные
член: член
статья: статьи статью
ссылка: ссылками ссылки ссылку
попасть: попали
энциклопедия: энциклопедии
читатьправитьправить: читатьправитьправить
некоммерческий: некоммерческой
статьяобсуждение: статьяобсуждение
футболист: футболист
коммуна: коммуна
кавалерийский: кавалерийский
ещё: ещё
генерал: генерал
конфиденциальность: конфиденциальности
французский: французская французский французской
правкиновое: правкиновые
игра: играх
армия: армии
ксавье: ксавье
смотреть: см
шестёрка: шестёрки
викидать: викиданных
персональный: персональные
департамент: департаменте
перейти: перейти
мочь: могут
округ: округ
дорожный: дорожный
русский: русский
условие: условий условия
мийо: мийо
страницасодержаниеизбрать: страницасодержаниеизбранные
соответствующий: соответствующие
также: также
навигация: навигации навигация
элемент: элемент
граф: граф
франция: франции франция
город: город города
товарный: товарный
слово: слова
авторство: авторства
зарегистрировать: зарегистрированный
википедия: википедии википедия
заглавный: заглавная
правкипостоянный: правкипостоянная
материал: материал
статьятекущий: статьятекущие
наполеоновский: наполеоновской
примечаниясписка: примечаниясписок
статьисообществофорумсправкасвежий: статьисообществофорумсправкасвежие
поведение: поведения
кук: куки
родиться: род
отредактировать: отредактирована
ошибкекак: ошибкекак
печать: печати
спортсменка: спортсменка
критик: критик
вернуться: вернитесь
эрик: эрик
политика: политика
статьислучайный: статьислучайная
статистика: статистика
композитор: композитор
имя: имён
записьвойти: записьвойти
фигурист: фигурист
виадук: виадук
доступный: доступен
дополнительный: дополнительные
значение: значений
нужный: нужную
организация: организации
гар: гар
добиться: добившаяся
вблизи: вблизи
франсуа: франсуа
короткий: короткий
скачать: скачать
представиться: представились
последний: последний
случай: случаях
вантовый: вантовый
текст: текст
фонд: фонд
учётный: учётную
проект: проектах
этот: эта
аверон: аверон
заявление: заявление
поиск: поиск поиску
церковный: церковный
страницуполучить: страницуполучить
фамилия: фамилия
сохранение: сохранением
уточнить: уточните
деятель: деятель
мобильный: мобильная
править: править
язык: языках
подробный: подробнее
разработчик: разработчики
право: права
алиса: алиса
знак: знак
описание: описание
сюдасвязанный: сюдасвязанные
отдельный: отдельных
участие: участие
атлетический: атлетических
другой: других
использование: использования
ответственность: ответственности
топоним: топоним
кристиан: кристиан
участник: участников
просмотр: просмотры
кодекс: кодекс
историк: историк
версия: версия
клод: клод
ссылкасведение: ссылкасведения
источник: источник
инструмент: инструменты
действовать: действовать
мост: мост
