мы: нами
дума: дум
алисий: алисии алисия
появление: появление появления
комикс: комиксах комиксов
леди: леди
обвинитель: обвинитель
пантера: пантера
сорвиголова: сорвиголова
способность: способность
шестёрка: шестёрка
отец: отцу
июнь: июнь июня
использовать: использующие
изменение: изменениями
управлять: управлять
эго: эго
статья: статьи
невидимый: невидимая
энциклопедия: энциклопедии
читатьправитьправить: читатьправитьправить
нэморита: нэморита
гонщик: гонщик
сатирический: сатирическую
старый: старейших
чародей: чародей
художник: художник художником
издатель: издатель
продукт: продуктах
глаз: глаз
правкиновое: правкиновые
матис: матисом
мультсериал: мультсериала мультсериале мультсериалы
перейти: перейти
алфавитуперсонаж: алфавитуперсонажи
девушка: девушки
примечание: примечания
положение: положение
страницасодержаниеизбрать: страницасодержаниеизбранные
элвин: элвин
хэнк: хэнк
уата: уату
пим: пим
америка: америка
навигация: навигации навигация
происхождение: происхождение происхождения
первый: первого первое
элемент: элемент
американский: американских
страница: страница странице страницы
википедия: википедии википедия
бывший: бывший
враг: враги врагов
статьятекущий: статьятекущие
год: года году лет
статьисообществофорумсправкасвежий: статьисообществофорумсправкасвежие
июль: июля
временной: временными
гидромен: гидромен
ричардс: ричардс
печать: печати
вымышленный: вымышленный
зло: зло
политика: политика
крия: крии
записьвойти: записьвойти
прочий: прочие
особый: особые
дополнительный: дополнительные
серебряный: серебряный
кукла: кукол
электро: электро
физически: физически
появиться: появившиеся появиться
кукольникивымышленный: кукольникивымышленные
гениальный: гениальный
фонд: фонд
криминальный: криминальный
мисс: мисс
ноябрь: ноябрь ноября
доктор: доктор
титаний: титания
поиск: поиск поиску
читаури: читаури
страницуполучить: страницуполучить
язык: язык языках
нелюди: нелюди
лэнг: лэнг
новый: нова новые
фантастика: фантастик
невероятный: невероятный
валерий: валерия
просмотр: просмотры
озвучить: озвученный озвучил
помощь: помощью
уилли: уилли
канга: канг
дебютировать: дебютировав
ссылкасведение: ссылкасведения
примечанияхстраница: примечанияхстраницы
линия: линии
отчим: отчим
вижн: вижн
второстепенный: второстепенные
действовать: действовать
отказ: отказ
событияпожертвовать: событияпожертвовать
сюжетный: сюжетные
замечать: замечает
появляться: появляется появлялся
планета: планета
кристалл: кристалл
горгон: горгон
указание: указанием
возлюбить: возлюбленной
викимедиа: викимедиа
свободный: свободной
связанный: связанные
волшебный: волшебные
некоммерческий: некоммерческой
тритон: тритон
содержание: содержание
тигр: тигра
годуперсонаж: годуперсонажи
кукловод: кукловод кукловода
сценарист: сценаристом
персонаж: персонаж персонажей персонажи
сноска: сносках сносок
гром: гром
придумать: придумал
персональный: персональные
указать: указан
занятие: занятий
полный: полное
условие: условий условия
создать: создан созданные
джек: джек джеком
также: также
мыслитель: мыслитель
преступник: преступник
четвёрка: четвёрка четвёрки четвёрку
ошибка: ошибка ошибками
расширение: расширение
росс: росс
расширить: расширенной
авторство: авторства
четвёркастэн: четвёркастэн
её: её
правкипостоянный: правкипостоянная
материал: материал
дата: дата
ливымышленный: ливымышленные
февраль: февраля
отредактировать: отредактирована
фильм: фильма фильмов
ошибкекак: ошибкекак
скрулла: скруллы
кетч: кетч
вид: вид
искусный: искусный
имя: имя имён
кло: кло
холт: холт
архивировать: архивировано
будущий: будущих
мочь: мог могут
август: августа
публикация: публикации публикаций
капитан: капитан
короткий: короткий
включить: включил
глина: глины
представиться: представились
являться: является
видеоигра: видеоигры
версия: версии версия
мститель: мстители
учётный: учётную
издательство: издательства
невозможный: невозможный
этот: эта
творец: творец
марвести: марвел
фамилия: фамилия
терракс: терракс
англ: англ
подробный: подробнее
фантастический: фантастическая фантастической фантастическую
разработчик: разработчики
оформить: оформленными
знак: знак
антагонистыосновный: антагонистыосновные
отдельный: отдельных
мистер: мистер
обложка: обложка
красный: красный
использование: использования
ужасающий: ужасающая
сентябрь: сентябрь
мефисто: мефисто
протяжение: протяжении
принадлежать: принадлежали
характеристика: характеристики
неопр: неопр
сандерс: сандерс
сообщить: сообщить
кодистория: кодистория
связаться: свяжитесь
многий: многих
сёрфер: сёрфер
код: код
который: которые которых
включая: включая
скотт: скотт
страницецитировать: страницецитировать
письмо: письмами
сноскамивикипедия: сноскамивикипедия
нил: нил
управление: управление
статьяобсуждение: статьяобсуждение
один: одним одном
кирбиперсонаж: кирбиперсонажи
студия: студии
читатель: читатель
ещё: ещё
тор: тор
боб: боб
интеллект: интеллект
карнак: карнак
аннигилус: аннигилус
живой: живая
викидать: викиданных
позиция: позиция
песочный: песочный
командыоригинальный: командыоригинальный
харкнесса: харкнесс
русский: русский
эпизод: эпизоде
художественный: художественной
человек: люди людьми человек
заглавный: заглавная
игра: игры
великий: величайшие
поведение: поведения
кук: куки
родиться: род
фьюри: фьюри
семейный: семейное
аттум: аттума
шторм: шторм
суперзлодей: суперзлодеи суперзлодей
бластаар: бластаар
слово: словам
фанат: фанатов
статистика: статистика
нейтральный: нейтральные
телевидение: телевидение
история: история
молекулярный: молекулярный
вдова: вдова
лепить: лепить
последний: последний
известный: известен известные
текст: текст
лампкина: лампкин
награда: награду
халк: халк
локджо: локджо
заявление: заявление
железный: железный
мобильный: мобильная
править: править
сюдасвязанный: сюдасвязанные
рекрут: рекруты
гидра: гидра
ответственность: ответственности
франклин: франклин
ронана: ронан
учёныевымышленный: учёныевымышленные
джеймс: джеймсом
наблюдатель: наблюдатель
альтер: альтер
кодекс: кодекс
наиболее: наиболее
категория: категории
май: мая
инструмент: инструменты
раскрыть: раскрыта
кирбичлен: кирбичлены
гладиатор: гладиатор
икс: икс
получить: получивший
системеобсуждениевкладсоздать: системеобсуждениевкладсоздать
соколиный: соколиный
чёрный: чёрная чёрный
трапстер: трапстер
лицензия: лицензии
союзник: союзники
радиоактивный: радиоактивной
пространство: пространства
диабло: диабло
стэн: стэн
зловещий: зловещая
вдовец: вдовец
страницыслужебный: страницыслужебные
призрачный: призрачный
силач: силач
ник: ник
ссылка: ссылки
сила: силы
дэнни: дэнни
дебют: дебют
конфиденциальность: конфиденциальности
танос: танос
странный: странных
смотреть: см
состав: состав
январь: январь
кукловодангл: кукловодангл
медиа: медиа
призрак: призрак
октябрь: октября
бакстер: бакстера
товарный: товарный
неверный: неверный
зарегистрировать: зарегистрированный
существо: существа существо
кино: кино
латверие: латверия
здание: здание
агата: агата
нэмор: нэмор
стэном: стэном
настоящий: настоящее
скульпторысуперзлодея: скульпторысуперзлодеи
тег: тег
росомаха: росомаха
герой: герои
галерея: галереи
статьислучайный: статьислучайная
галактус: галактус
доступный: доступен
мастерс: мастерс
автор: авторы
момент: момента
организация: организации
антагонист: антагонистов
скачать: скачать
филипп: филипп
случай: случаях
неправильно: неправильно
орден: орден
максимус: максимус
лорд: лорд
гений: гений
проект: проектах
самый: самых
локация: локации
критика: критика
воин: воины
вне: вне
медуза: медуза
сохранение: сохранением
биолог: биолог
топ: топ
обращение: обращения
описание: описание
участие: участие
завоеватель: завоеватель
другой: других
персонажиглавный: персонажиглавные
кирби: кирби
лайдж: лайджа
мир: мира
источник: источник
безумный: безумный
огненный: огненный
