войти: войти
прошлый: прошлом
италия: италии италия
свой: своё
описание: описание
авторство: авторства
материал: материал
атд: атд
деление: деления
поиск: поиск поиску
ссылка: ссылка ссылками ссылки ссылок
распределённый: распределённые
инструмент: инструменты
страница: страница странице страницу страницы
также: также
представиться: представились
храм: храм храма храмов
мария: марии
область: область
каникатти: каникатти
текст: текст
кодекс: кодекс
иначе: иначе
москвин: москвин
кастельтерминь: кастельтермини
викисклад: викисклад викискладе
медиафайл: медиафайлы
каламонач: каламоначи
дух: духа
св: св
использовать: использующие
согласие: согласия
входить: входят
событие: события
пункт: пункты
место: места месте
случай: случаях
доминик: доминика
долина: долина долине
схема: схема
источник: источник источниками источники источников
гротт: гротте
статья: статье статьи статью статья
скрытый: скрытые
путеводитель: путеводитель
кальтаниссетта: кальтаниссетта
служебный: служебные
комитиня: комитини
условие: условий условия
версия: версия
эудженио: эудженио
административный: административные административных
перейти: перейти
идентификатор: идентификаторы
катание: катания
связаться: свяжитесь
земля: земля
незавершённый: незавершённые
множество: множество
рибера: рибера
сиц: сиц
метрополитенский: метрополитенские
фонд: фонд
мочь: могут можете
нарый: наро
раффадаля: раффадали
навигация: навигации навигация
состав: состав
население: население
юнона: юноны
кальтабеллотт: кальтабеллотта
октябрь: октября
заглавный: заглавная
волшебный: волшебные
рекомендация: рекомендации
заготовка: заготовка
содержание: содержание
пелагский: пелагские
трапани: трапани
сицилия: сицилии сицилия
церковь: церковь
получить: получили получить
код: код
реальмонт: реальмонте
равануза: равануза
её: её
широта: ш
этот: эта
герб: герб
авторитетный: авторитетные
руина: руины
правка: правка правки
прославить: прославивших
год: года году
алфавит: алфавиту
археологический: археологический
русский: русский
пожертвовать: пожертвовать
монтеваго: монтеваго
сиракуза: сиракуза
почтовый: почтовые
основный: основными
язык: языках
некоммерческий: некоммерческой
сообщество: сообщество
заявление: заявление
плотность: плотность
ответственность: ответственности
агридженто: агридженто
српски: српски
персональный: персональные
отредактировать: отредактирована отредактировать
литература: литература
география: география
линия: линия
лаврентий: лаврентия
собор: собор соборов
система: системе
телефонный: телефонный
населённый: населённые
ликат: ликата
сообщить: сообщить
пояс: пояс
избранный: избранные
википедия: википедии википедия
лицензия: лицензии
регион: регионе
арагон: арагона
зевс: зевса
ещё: ещё
единица: единицах единице единицы
гора: гора
театр: театр
цифровой: цифровые
линоз: линоза
столица: столица
исторический: исторический
править: править
море: морем
действовать: действовать
парк: парк
подробный: подробнее
ошибка: ошибке
часовой: часовой
береговой: береговая
обсуждение: обсуждение
кук: куки
монталлегро: монталлегро
последний: последний последняя
участие: участие
роза: розе
средиземный: средиземным
запись: запись
форум: форум
бурджо: бурджо
достопримечательность: достопримечательностями
аббатство: аббатство
шакка: шакка
создать: создать
имя: имён
номер: номеров
остров: острова
тип: типам
печать: печати
постоянный: постоянная
страна: страна
город: город города
викидать: викиданных
бивон: бивона
пространство: пространства
лампион: лампионе
монт: монте
упразднить: упразднённые
знак: знак
галерея: галерея
товарный: товарный
сюда: сюда
скачать: скачать
карта: картами
вклад: вклад
сайт: сайт
упразднение: упразднения
мессина: мессина
геракл: геракла
сведение: сведения
глава: глава
другой: других
српскохрватски: српскохрватски
название: название
июнь: июня
провинция: провинции провинция
коммуна: коммуны
сноска: сносок
чанчан: чанчана
каммарат: каммарата
вече: вече
греческий: греческий
цитировать: цитировать
хватать: хватает
зарегистрировать: зарегистрированный
политика: политика
просмотр: просмотры
помочь: помогите
проверять: проверяема
чел: чел
свежий: свежие
смотреть: см
лампедуза: лампедуза
справка: справка
новый: новые
кастрофилиппо: кастрофилиппо
элемент: элемент
български: български
омываться: омывается
читать: читать
мы: нами
считаться: считаются
древний: древний
вулкан: вулканов
текущий: текущие
индекс: индексы
камастр: камастра
добавить: добавив
автом: автом
палермо: палермо
история: история
мобильный: мобильная
энциклопедия: энциклопедии
прежде: прежде
кафедральный: кафедральный
доступный: доступен
оставить: оставивший
сикульян: сикульяна
акрагас: акрагас
одноимённый: одноимённый
учётный: учётную
ирон: ирон
короткий: короткий
дополнить: дополнив
викимедиа: викимедиа
энна: энна
использование: использования
площадь: площадь
случайный: случайная
удалить: удалена
находиться: находится
категория: категории
информация: информация
фавар: фавара
лето: летом
рагуза: рагуза
ландшафтный: ландшафтный
отдельный: отдельных
ракальмуть: ракальмуто
отказ: отказ
проект: проектах
сохранение: сохранением
свободный: свободной
указание: указанием
конфиденциальность: конфиденциальности
официальный: официальный
связанный: связанные
дата: дата
менфи: менфи
поведение: поведения
должный: должна
разработчик: разработчики
вид: виде
дополнительный: дополнительные
стоять: стоял
это: это
немой: нем
примечание: примечания
организация: организации
август: августа
итал: итал
статистика: статистика
