войти: войти
прошлый: прошлом
девять: девять
описание: описание
авторство: авторства
джиллиана: джиллиан
материал: материал
впоследствии: впоследствии
поиск: поиск поиску
внешний: внешние
тедди: тедди
инструмент: инструменты
стиль: стиле
образование: образование образования
ведущий: ведущих
страница: страница странице страницу страницы
значительно: значительно
назначать: назначаемыми
обращение: обращения
наука: науку
выпустить: выпустила
коллегия: коллегию
библиографический: библиографических
представиться: представились
выпускник: выпускниками выпускники выпускников
расположение: расположения
адвокат: адвокатами адвокатов
текст: текст
кодекс: кодекс
твиттер: твиттер
викисклад: викисклад викискладе
эксперимент: эксперимент
указать: указан
федералист: федералиста
медиафайл: медиафайлы
время: времена время
советник: советников
плющ: плюща
событие: события
север: север
лига: лиги
число: числе
дуайт: дуайт дуайтом
случай: случаях
джей: джей
преобразовать: преобразован
отличаться: отличаться
частный: частных
ресурс: ресурсы
штат: штат штатов
статья: статьи статья
скрытый: скрытые
служебный: служебные
сенатор: сенаторы
здание: здание
правительство: правительства
версия: версии версия
условие: условий условия
статистика: статистика
университет: университет университета университеты
который: которые которыми
фирма: фирмах
изучать: изучал
главный: главным
перейти: перейти
судья: судей судья
млн: млн
располагаться: располагалось
поверхностный: поверхностными
связаться: свяжитесь
сеть: сетях
множество: множество
один: одной
архивировать: архивировано
мир: мире
юридический: юридическая юридических юридического юридическое юридической
фонд: фонд
март: марта
пятёрка: пятерку
мочь: могут
рассматривать: рассматривали
навигация: навигации навигация
юрист: юристов юристы
королевский: королевского
заглавный: заглавная
содержание: содержание
многочисленный: многочисленных
код: код
учредитель: учредитель
школа: школ школа школах школы
британский: британского
довольно: довольно
широта: ш
соединить: соединенных соединённых
знание: знаний знания
получение: получения
компетентный: компетентных
колумбийский: колумбийский колумбийского
этот: эта
право: права право
правка: правка правки
суд: суда судами
основать: основан основана основанные
правление: правления
основание: основание
адвокатский: адвокатских
выдающийся: выдающиеся выдающихся
год: года году
алфавит: алфавиту
русский: русский
пожертвовать: пожертвовать
гамильтон: гамильтон
верховный: верховного верховный
предоставить: предоставлены
язык: язык языках
место: место
профессор: профессор
некоммерческий: некоммерческой
сообщество: сообщество
заявление: заявление
выяснить: выяснить
лестница: лестницу
ответственность: ответственности
персональный: персональные
отредактировать: отредактирована
система: системе
работать: работают
проверка: проверки
любой: любая
секретарь: секретарь
ссылка: ссылка ссылки
многие: многие
сообщить: сообщить
избранный: избранные
википедия: википедии википедия
объект: объекты
проверить: проверенной
лицензия: лицензии
зачастую: зачастую
обучение: обучение
ещё: ещё
первый: первое первый
потребность: потребность
удобный: удобную
целевой: целевой
район: район
неопр: неопр
аспирантура: аспирантурой
править: править
формальный: формальном
учиться: учиться
действовать: действовать
подробный: подробнее
хороший: лучших
декабрь: декабря
франклин: франклина
ошибка: ошибке
практика: практики
политический: политической
александр: александр
относиться: относились
мелкий: мелких
обсуждение: обсуждение
кук: куки
лестер: лестер
последний: последний последняя
карьера: карьере
джон: джон
спорный: спорной
участие: участие
должный: должны
президент: президент президента президентов
запись: запись
форум: форум
кампус: кампусе
создать: создать
имя: имён
представитель: представители
печать: печати
постоянный: постоянная
уровень: уровне
викидать: викиданных
контора: конторах
сша: сша
основное: основном
пространство: пространства
губернатор: губернаторы
колумбия: колумбия
большинство: большинство
экзамен: экзамены
комитет: комитетами
знак: знак
сам: самим
получить: получить
теодор: теодор теодором
товарный: товарный
сюда: сюда
скачать: скачать
карта: картами
называться: назывался
вклад: вклад
сайт: сайт
требовать: требуют
опытный: опытными
сведение: сведения
выполнить: выполнено
профессиональный: профессиональной
другой: другая других
делать: делано
српскохрватски: српскохрватски
рузвельт: рузвельта
июнь: июня
деталь: деталях
являться: является
неоготический: неоготическом
казначейство: казначейства
соавтор: соавторы
учреждение: учреждениях
офис: офисах
цитировать: цитировать
антропогенный: антропогенные
зарегистрировать: зарегистрированный
политика: политика
просмотр: просмотры
колледж: колледж колледжа
заведение: заведения
академический: академических
участник: участниками
проводиться: проводились
свежий: свежие
смотреть: см
справка: справка
новый: новые
мало: мало
проверяться: проверялась
элемент: элемент
создание: создании
читать: читать
мы: нами
заметить: заметил
знакомый: знакомы
официально: официально
текущий: текущая текущие
полностью: полностью
низкий: низком
история: история
мобильный: мобильная
кандидат: кандидата
записка: записок
подняться: подняться
энциклопедия: энциклопедии
доступный: доступен
курс: курсе
переехать: переехал
источник: источник
учётный: учётную
короткий: короткий
викимедиа: викимедиа
использование: использования
рассматриваться: рассматривалось
случайный: случайная
каталог: каталогах
пока: пока
ремесло: ремесло
очень: очень
учебный: учебные
проходить: проходили
категория: категории
клерк: клерки
элитный: элитных
называть: называли
отдельный: отдельных
отказ: отказ
поступление: поступления
проект: проектах
студент: студентов
сохранение: сохранением
свободный: свободной
указание: указанием
конфиденциальность: конфиденциальности
официальный: официальный
связанный: связанные
дата: дата
такой: такие
поведение: поведения
страна: страны
социальный: социальных
разработчик: разработчики
дополнительный: дополнительные
входить: входит
это: это
целое: целом
примечание: примечания
организация: организации
возможность: возможности
географический: географические
скептически: скептически
образ: образом
однако: однако
январь: января
член: членов членом
агео: агео
стремиться: стремились
