мы: нами
поездка: поездки
лейкозакоролевыскрыть: лейкозакоролевыскрытые
александрия: александрии александрия
третий: третьей
греция: греция
леди: леди
семья: семье семьи семья
альянс: альянса
число: числе
впервые: впервые
дизайн: дизайн
использовать: использующие
женщина: женщин женщины
президентство: президентства
судья: судья
поздний: позже
апелляционный: апелляционного
али: али
статья: статьи
награда: награды
энциклопедия: энциклопедии
разработать: разработан
стать: став стал стала
сентябрь: сентябре сентября
специальный: специального
версияправитьправить: версияправитьправить
художник: художник
правкиновое: правкиновые
египет: египет египта египте
который: которого которое которой
образование: образование
тот: те
перейти: перейти
примечание: примечания
страницасодержаниеизбрать: страницасодержаниеизбранные
навигация: навигации навигация
бриллиант: бриллиантами
фарид: фарида
материнский: материнской
страница: страница страницы
иметь: иметь
зульфикар: зульфикар
парижский: парижским
википедия: википедии википедия
годуумерший: годуумершие
статьятекущий: статьятекущие
год: года годов году годы лет
статьисообществофорумсправкасвежий: статьисообществофорумсправкасвежие
полумесяц: полумесяца
париж: париже
общественный: общественная общественной
июль: июля
крест: крест креста
родиться: род родившиеся родилась родилось
печать: печати
событие: событиях
гость: гостей
французский: французских
жена: жена
политика: политика
анвар: анвара
устраивать: устраивала
король: король короля королём
записьвойти: записьвойти
дополнительный: дополнительные
брак: брак браке
конец: конце
медиафайл: медиафайлы
жизнь: жизни
один: одна одни
влияние: влияния
ребёнок: детей дети
рисовать: рисовать
инициал: инициалы
фонд: фонд
книга: книга
разлука: разлуки
поиск: поиск поиску
страницуполучить: страницуполучить
язык: язык языка языках
отец: отец
выйти: вышла
организовывать: организовывать
свадьба: свадьба
союз: союза
март: март марта марте
принадлежать: принадлежала
просмотр: просмотры
свой: свои своих
иностранный: иностранные иностранных
саввыперсоналия: саввыперсоналии
супруг: супруг
европа: европе
архивный: архивная
ссылкасведение: ссылкасведения
линия: линии
каир: каир каире
материнство: материнство
греческий: греческого
действовать: действовать
отказ: отказ
событияпожертвовать: событияпожертвовать
класс: класса
дядя: дядей
проверка: проверки
фуад: фуадом
приоритет: приоритетом
рим: риме
школа: школе
время: время
новый: новых
указание: указанием
фавзия: фавзия
викисклад: викискладе
вд: вд
викимедиа: викимедиа
читатьтекущий: читатьтекущая
свободный: свободной
покровитель: покровителем
волшебный: волшебные
некоммерческий: некоммерческой
королевский: королевское королевской
кавалер: кавалеры
содержание: содержание
согласно: согласно
посетить: посетили
развод: развода
денежный: денежных
персональный: персональные
александрииумереть: александрииумершие
указать: указан
условие: условий условия
некорректный: некорректным
младший: младшая
смешанный: смешанного
также: также
два: двух
январь: января
знатный: знатной
выходить: выходила
запад: запада
посещать: посещать
авторство: авторства
её: её
правкипостоянный: правкипостоянная
материал: материал
дата: дата
поместить: помещена
египетский: египетская египетским египетских египетское египетской
дворец: дворце
февраль: февраля
отредактировать: отредактирована
ошибкекак: ошибкекак
детство: детство
страна: страны
наследник: наследника
гианаклис: гианаклисе
сбор: сбор
умереть: умер умерла
имя: имя имён
архивировать: архивировано
добродетеликавалер: добродетеликавалеры
феминистский: феминистского
август: августа
короткий: короткий
представиться: представились
изменение: изменения
фарука: фарук фарука
июнь: июня
версия: версии версия
савва: саввы
находиться: находившейся
учётный: учётную
этот: эта
почётный: почётным
сша: сша
королева: королева королевой
англ: англ
подробный: подробнее
разработчик: разработчики
знак: знак
важный: важной важную
отдельный: отдельных
особенно: особенно
лейкемия: лейкемией лейкемии
махмуд: махмуд
использование: использованием использования
принцесса: принцесса
товарищество: товарищества
немой: нем
ожидать: ожидают
жить: жила
река: реке
викискладэлемент: викискладэлемент
вместе: вместе
шаблон: шаблонов
однако: однако
сыграть: сыграло
октябряумереть: октябряумершие
протяжение: протяжении
впасть: впала
сербия: сербия
обязанность: обязанностями
самый: самая
мужской: мужского
встретиться: встретились
неопр: неопр
сообщить: сообщить
красный: красного
александрийский: александрийского
первый: первая первой первых
рождение: рождение рождении рождения
кодистория: кодистория
связаться: свяжитесь
вернуться: вернулась
код: код
дед: дедом
страницецитировать: страницецитировать
средство: средств
средний: среднее
рост: ростом
нил: нил
мухаммад: мухаммада
статьяобсуждение: статьяобсуждение
ещё: ещё
добродетель: добродетели
династия: династия
викидать: викиданных
мочь: могут
русский: русский
ведение: ведении
тело: тело
лондон: лондон
вырасти: выросла
правление: правление
президент: президентом
обручиться: обручились
заглавный: заглавная
поведение: поведения
кук: куки
несколько: несколькими
святой: святого
свадебный: свадебное
дамский: дамский
последний: последние последний
проходить: проходила
статистика: статистика
памятный: памятных
мероприятие: мероприятия мероприятиях
морг: морге
фадий: фадия
выставка: выставки выставок
увидеть: увидела
оставаться: оставалась
развестись: развёлся
возглавить: возглавила
текст: текст
дом: домом
престол: престола
пол: пола
заявление: заявление
фарида: фаридой
начальный: начальное
остров: острове
мобильный: мобильная
кто: кому
править: править
замужество: замужества
отделение: отделение
суд: суда
сюдасвязанный: сюдасвязанные
смерть: смерть
соответствие: соответствии
сафиназа: сафиназ
проверить: проверена
ответственность: ответственности
затем: затем
дочь: дочери дочерях
гепатит: гепатитом
юсеф: юсеф
копия: копия
кодекс: кодекс
категория: категории
май: мае мая
лето: летом
инструмент: инструменты
начало: начала
кубба: кубба
системеобсуждениевкладсоздать: системеобсуждениевкладсоздать
благотворительный: благотворительные
благотворительность: благотворительность
орден: орден ордена
вопрос: вопросах
большой: большого большой
замуж: замуж
остаться: осталась
замалек: замалеке
лицензия: лицензии
человек: людях
сентябряродившийся: сентябряродившиеся
ферьял: ферьял
пространство: пространства
девочка: девочек
стабильный: стабильная
участвовать: участвовать
должный: должны
страницыслужебный: страницыслужебные
ссылка: ссылки
черкес: черкесам
платье: платье
забота: заботу
ливана: ливан
приём: приёме
величество: величество
конфиденциальность: конфиденциальности
взять: взял
смотреть: см
пневмония: пневмонией
традиция: традицией
годуродиться: годуродившиеся
госпитализировать: госпитализирована
член: члены
единственный: единственным
октябрь: октября
одетый: одета
товарный: товарный
неверный: неверный
мухаммед: мухаммед
зарегистрировать: зарегистрированный
инициировать: инициированной
аликавалер: аликавалеры
каирединастия: каирединастия
роль: роль
масри: масри
связь: связи
статьислучайный: статьислучайная
доступный: доступен
алфавитуумереть: алфавитуумершие
организация: организации
пригород: пригороде
скачать: скачать
состояться: состоялась
монахиня: монахинь
случай: случаях
десять: десяти
проект: проектах
мода: моды
фамилия: фамилией
реанимация: реанимацию
титул: титулом
сохранение: сохранением
обращение: обращения
важно: важно
получить: получила
статус: статус
описание: описание
участие: участие
ноябрь: ноября
другой: других
национальный: национальные
возраст: возрасте
диагноз: диагнозами
источник: источник источниками
переехать: переехала
известный: известный
