мы: нами
ассоциация: ассоциаций
религиозный: религиозное религиозные
миллс: миллс
рэймонд: рэймонда
единица: единица
управлять: управляющие
другой: другие другими других
управление: управление управления
назначить: назначенные
судебный: судебное
общий: общие
экономический: экономическая
неуказанный: неуказанного
ставиться: ставится
политический: политическая политические политический политических политическое политической
изменение: изменениями
годавикипедия: годавикипедия
влияние: влияние влиянием
статья: статьи статью
создать: созданной
воспроизводство: воспроизводства
получать: получающий
энциклопедия: энциклопедии
читатьправитьправить: читатьправитьправить
сфера: сфера сферах
сентябрь: сентября
частность: частности
богатство: богатства
правкиновое: правкиновые
значительный: значительным
соединить: соединенных
образование: образование
закон: закон закону
гегемония: гегемония
перейти: перейти
примечание: примечания
страницасодержаниеизбрать: страницасодержаниеизбранные
языкавикипедия: языкавикипедия
навигация: навигации навигация
индивидуальный: индивидуальных
средство: средства
элемент: элемент элемента
заменить: заменена
число: числу
утверждать: утверждал
страница: страница страницы
попадать: попадает
идея: идея
тип: типы
википедия: википедии википедия
просто: просто
статьятекущий: статьятекущие
год: года году
статьисообществофорумсправкасвежий: статьисообществофорумсправкасвежие
июль: июля
бурдие: бурдье
печать: печати
проверить: проверить
век: веке
относиться: относится относятся
концепция: концепцией концепцию концепция
любой: любого
политика: политика политики политику
изучать: изучал
функция: функции
ассоциативный: ассоциативное
ряд: ряд
записьвойти: записьвойти
распределение: распределение
дополнительный: дополнительные
жизнь: жизни
часто: часто
объединение: объединение
определённый: определённой определённую определённые
состоять: состоящий
теория: теорию
фонд: фонд
объединяться: объединяются
лицо: лица
элита: элиты
поиск: поиск поиску
страницуполучить: страницуполучить
яковенко: яковенко
недавно: недавно
язык: язык языка языках
технократический: технократической
господствующий: господствующего
реагировать: реагирует
друг: друг друга
шаблон: шаблонами
бюрократия: бюрократия
компания: компании компаний
наёмный: наемные
структура: структуре
просмотр: просмотры
так: т
статистический: статистическое статистическую
такой: такими таких
грауве: грауве
контроль: контролем
экономика: экономики
пример: пример примере
ссылкасведение: ссылкасведения
профессиональный: профессионального
представитель: представителей представители представителями
действовать: действовать
социология: социологии
результат: результате
отказ: отказ
правовой: правовое
событияпожертвовать: событияпожертвовать
объединить: объединить
потребитель: потребителей
класс: класс класса классов
формация: формации формаций
сеть: сети
рынок: рынке
международный: международных
правящий: правящего правящей правящий
контролировать: контролируют
временной: временной
указание: указанием
реальность: реальность
учёный: ученые
группа: группа группе группу
викимедиа: викимедиа
алфавит: алфавиту
единство: единства
свободный: свободной
должность: должностей
раймона: раймона
некоммерческий: некоммерческой
представлять: представляющих
продемонстрировать: продемонстрировали
небольшой: небольшой
разный: разные
содержание: содержание
благо: блага
основное: основном
персональный: персональные
указать: укажите указал указан
элитный: элитные
условие: условий условия
переводвикипедия: переводвикипедия
также: также
уменьшаться: уменьшается
зрение: зрения
два: двух
январь: января
интеллектуальный: интеллектуальное
эксперт: эксперты
фильм: фильм
авторство: авторства
классовый: классовой классовыми
иллюстрироваться: иллюстрируется
мочь: могут можете
оказывать: оказывают
правкипостоянный: правкипостоянная
материал: материал
дата: дата
демонстрироваться: демонстрируется
отредактировать: отредактирована
социолог: социолог
ошибкекак: ошибкекак
последний: последнее последний
богатый: богатых
группыскрыть: группыскрытые
страна: страны
свой: своим
этот: эта этими
писатель: писатели
нато: нато
имя: имён
архивировать: архивировано
август: августа
короткий: короткий
представиться: представились
максимальный: максимальные
являться: является
больший: наибольшей
область: области
буржуазия: буржуазия
учётный: учётную
это: это
маркс: маркс
предприятие: предприятие
рекомендация: рекомендации
управленческий: управленческой
аппарат: аппарат
деятель: деятелей
существование: существование
сша: сша
англ: англ
военный: военные
подробный: подробнее
разработчик: разработчики
недостаток: недостатков
объединять: объединяет
отметить: отметил отметить
знак: знак
отдельный: отдельных
использование: использованием использования
кристиан: кристиан
фондовый: фондовом
который: которая которые который которых
легитимизировать: легитимизирует
точка: точки
государственный: государственный
наглядно: наглядно
производитель: производителей
пожалуйста: пожалуйста
доход: доходов
клуб: клубах
неопр: неопр
сообщить: сообщить
работа: работе
банк: банками
пр: пр
общество: общества
кодистория: кодистория
связаться: свяжитесь
код: код
власть: власти власть властью
страницецитировать: страницецитировать
образовательный: образовательные
улучшить: улучшить
человек: людей люди
интеллигенция: интеллигенция
известный: известных
исправить: исправить
сомнение: сомнение
каждый: каждая
статьяобсуждение: статьяобсуждение
большинство: большинства большинство
ещё: ещё
монополизировать: монополизирующего
различный: различных
заполнение: заполнения
смена: сменой
викидать: викиданных
стабильно: стабильно
пьер: пьер
русский: русский
необходимо: необходимо
судья: судьи
институциональный: институциональная
качество: качество
население: населения
черта: черты
франция: франция
механизм: механизмы
заглавный: заглавная
демократия: демократии
технократия: технократия
персонал: персонал
поведение: поведения
кук: куки
сознание: сознания
несколько: несколько
перевод: перевод перевода переводу
менее: менее
драматический: драматической
художник: художники
слово: словам
статистика: статистика
акционер: акционеры
обладать: обладающих
крупный: крупные крупных
стилистический: стилистические
сменять: сменяют сменяющих
частный: частных
текст: текст
финансовый: финансовая финансовых
штат: штатов
лондонский: лондонской
заявление: заявление
анархия: анархия
руководитель: руководителей руководители
мобильный: мобильная
править: править
журналист: журналисты
сюдасвязанный: сюдасвязанные
соответствие: соответствии
назвать: назвал
ответственность: ответственности
практика: практиками
основать: основана
иметь: имеют
термин: термина
отбор: отбора
кодекс: кодекс
версия: версия
выбрать: выбранные
наиболее: наиболее
категория: категории категорий
май: мая
инструмент: инструменты
социальный: социального социальный социальных
сотрудник: сотрудниками
член: членов
системеобсуждениевкладсоздать: системеобсуждениевкладсоздать
форма: форме
институт: институты
корпорация: корпораций
многие: многие
следовать: следует
дворянство: дворянством
предложить: предложил
борьба: борьбы
лицензия: лицензии
пространство: пространства
помочь: помочь
виктор: виктор
сгруппировать: сгруппированы
производство: производства
доминировать: доминирующего доминирующих
собственность: собственности
страницыслужебный: страницыслужебные
модель: модели
школа: школы
содержательный: содержательные
ссылка: ссылки
сми: сми
советник: советники
половина: половины
национальный: национальных
де: де
конфиденциальность: конфиденциальности
участие: участие участием
идеология: идеологии идеология
лидер: лидеры
парето: парето
смотреть: см
поле: поле
прокурор: прокуроры
пролетариат: пролетариат
олигархия: олигархия
руководящий: руководящих
независимый: независимые
ошибка: ошибки
наука: науке
медиа: медиа
райт: райт
октябрь: октября
товарный: товарный
зарегистрировать: зарегистрированный
значение: значения
микроинфлюенсер: микроинфлюенсеров
технократ: технократы
конгресс: конгресса
элитистский: элитистские
статьислучайный: статьислучайная
ведущий: ведущие
увеличиваться: увеличивается
доступный: доступен
организация: организации
привилегированный: привилегированный
отличаться: отличается
скачать: скачать
случай: случаях
духовный: духовной
бельгия: бельгия
непосредственный: непосредственное
проект: проектах
арон: арона
господство: господства
пол: пол
сохранение: сохранением
ситуация: ситуацией
обращение: обращения
классификация: классификация
орган: органов
карл: карл
описание: описание
сильва: сильва
ноябрь: ноября
миллиардер: миллиардеры
существовать: существуют
плохой: плохой
сосредоточить: сосредоточивший
профессор: профессор
источник: источник
социологияполитикасоциальный: социологияполитикасоциальные
