мы: нами
телефонный: телефонная телефонной телефонный телефонных
вещать: вещало
наследие: наследие
линия: линий
дания: дания
греция: греция
категория: категории категория
число: числе число
прекратить: прекращено
занимать: занимает занимала
статья: статья
аналоговый: аналоговое
фарерский: фарерские
телекоммуникация: телекоммуникаций
скорость: скорость скоростью
официальный: официальный
энциклопедия: энциклопедии
лихтенштейн: лихтенштейн
читатьправитьправить: читатьправитьправить
зарегистрировать: зарегистрированный зарегистрировано
сентябрь: сентября
правкиновое: правкиновые
частичнопризнать: частичнопризнанные
молдова: молдова
давать: дающая
деятельность: деятельности
образование: образование
перейти: перейти
примечание: примечания
страницасодержаниеизбрать: страницасодержаниеизбранные
житель: жители
навигация: навигации навигация
франция: франции францию франция
швеция: швеция
страница: страница страницы
проходить: проходят
служба: служба
википедия: википедии википедия
юнеско: юнеско
статьятекущий: статьятекущие
статьисообществофорумсправкасвежий: статьисообществофорумсправкасвежие
национальный: национальная национальное национальный
литва: литва
модуль: модулем
печать: печати
забросить: заброшенных
великобритания: великобритания
вооружённый: вооружённые
французский: французских
развитие: развитием
включать: включает
политика: политика
ранее: ранее
записьвойти: записьвойти
телевещание: телевещание
исландия: исландия
герб: герб
дополнительный: дополнительные
зона: зонах
год: год году годы
фонд: фонд
доступно: доступно
телеканал: телеканал телеканалы
мэн: мэн
приднестровье: приднестровье
государство: государства
срок: срока
поиск: поиск поиску
страницуполучить: страницуполучить
соединение: соединения
международный: международной
язык: языках языки
передача: передачи
пользователь: пользователей
хозяйство: хозяйство
насчитываться: насчитывается насчитывалось
компания: компании компания
словакия: словакия
просмотр: просмотра просмотры
население: население
доступный: доступен доступны
ссылкасведение: ссылкасведения
дать: дала
истечение: истечения
действовать: действовать
андорра: андорра андорре андорры
болгария: болгария
отказ: отказ
эстония: эстония
событияпожертвовать: событияпожертвовать
религия: религия
хотя: хотя
верхний: верхнего
зависимость: зависимости
известный: известной
праздник: праздники
ватикан: ватикан
туризм: туризм
время: время
система: система
указание: указанием
использоваться: используется
непризнанный: непризнанные
радиовещание: радиовещание
тема: темах
викимедиа: викимедиа
свободный: свободной
некоммерческий: некоммерческой
мальта: мальта
польша: польша
содержание: содержание
декабрь: декабря
основное: основном
венгрия: венгрия
нидерланды: нидерланды
гибралтар: гибралтар
персональный: персональные
домен: домен
условие: условий условия
италия: италия
также: также
странамскрыть: странамскрытая
территория: территории
развиваться: развивается
первый: первый
авторство: авторства
албания: албания
остров: остров острова
её: её
правкипостоянный: правкипостоянная
материал: материал
северный: северная
македония: македония
каталан: каталан
отредактировать: отредактирована
ошибкекак: ошибкекак
португалия: португалия
парламент: парламент
страна: стране страны
имя: имён
каталония: каталонии
вещатель: вещатель
литература: литература
ссылка: ссылки ссылкой
технология: технологии
швейцария: швейцария
короткий: короткий
представиться: представились
являться: является
норвегия: норвегия
учётный: учётную
джерси: джерси
этот: эта этому
азия: азией азии
иметь: имеет имеют
столица: столица
подробный: подробнее
разработчик: разработчики
знак: знак
флаг: флаг
отдельный: отдельных
европа: европой европы
место: место
использование: использования
использовать: использовала
викискладэлемент: викискладэлемент
экономика: экономика
государственный: государственный
кат: кат
сербия: сербия
гимн: гимн
транспорт: транспорт
предоставить: предоставить
сообщить: сообщить
гернси: гернси
быстро: быстро
мобильный: мобильная мобильной
всемирный: всемирное
кодистория: кодистория
связаться: свяжитесь
основный: основная
уровень: уровня
код: код
страницецитировать: страницецитировать
финляндия: финляндия
мир: мире
канал: каналы
германия: германия
полностью: полностью
конституция: конституция
статьяобсуждение: статьяобсуждение
культура: культура
ещё: ещё
появиться: появился
внешний: внешняя
строй: строй
испания: испании испанию испания
красный: красной
викидать: викиданных
мочь: могут
русский: русский
аландский: аландские
единственный: единственная единственным
связьнезависимый: связьнезависимые
счёт: счёт
фиксировать: фиксированной
радиостанция: радиостанцией радиостанций
заглавный: заглавная
собственный: собственный
поведение: поведения
кук: куки
граница: границы
музыка: музыка
административный: административное
статистика: статистика
обещание: обещание
город: города городах
телевидение: телевидение
история: история
марка: марки
вытеснить: вытеснил
последний: последний
южный: южная
возможность: возможность
текст: текст
заниматься: занимается
отвечать: отвечает
заявление: заявление
радио: радио
править: править
запустить: запущен
сюдасвязанный: сюдасвязанные
ответственность: ответственности
словения: словения
спорт: спорт
кодекс: кодекс
версия: версия
австрия: австрия
май: мая
инструмент: инструменты
возобновляться: возобновлялось
люксембург: люксембург
украина: украина
системеобсуждениевкладсоздать: системеобсуждениевкладсоздать
румыния: румыния
энкампа: энкампе
испанский: испанских
крупный: крупнейшей
лицензия: лицензии
тысяча: тысяч
пространство: пространства
черногория: черногория
босния: босния
показатель: показателю
страницыслужебный: страницыслужебные
сила: силы
цифровой: цифровое
география: география
герцеговина: герцеговина
кинематограф: кинематограф
конфиденциальность: конфиденциальности
беларусь: беларусь
радиорелейный: радиорелейную
смотреть: см
прослушивать: прослушивать
проведение: проведения
оптоволоконный: оптоволоконная оптоволоконные
андоррский: андоррской
чехия: чехия
товарный: товарный
деление: деление
шпицберген: шпицберген
городской: городских
благодаря: благодаря
монако: монако
андоррысвязь: андоррысвязь
латвия: латвия
настоящий: настоящее
остаться: остались
связь: связи связь
валюта: валюта
статьислучайный: статьислучайная
телекоммуникационный: телекоммуникационной
передатчик: передатчика
наука: наука
организация: организации
скачать: скачать
зависимый: зависимые
хорватия: хорватия
случай: случаях
почта: почта
бельгия: бельгия
вещание: вещание
проект: проектах
телеприёмник: телеприёмников
современный: современная
радиоприёмник: радиоприёмников
сохранение: сохранением
ирландия: ирландия
описание: описание
участие: участие
интернет: интернет интернета
другой: других
сельский: сельское
косово: косово
источник: источник
выделить: выделенных
