язык: языка языках
жанарык: жанарык
войти: войти
мужчина: мужчин мужчина
помочь: помогите
жанакорганский: жанакорганский жанакорганского жанакорганском
км: км
центр: центр центра
татарча: татарча
действовать: действовать
подробный: подробнее
баспакколь: баспакколь
статья: статьи статья
като: като
ошибка: ошибке
часовой: часовой
население: население населения
бесарык: бесарык
талапский: талапский
описание: описание
проживать: проживало
округ: округ округа
авторство: авторства
материал: материал
позапозапрошлый: позапозапрошлом
сентябрь: сентября
келинтоба: келинтобе
корасана: корасан
заглавный: заглавная
бирлик: бирлик
сунакат: сунаката
статус: статус
заготовка: заготовка
содержание: содержание
поиск: поиск поиску
населить: населённом населённый населённых
база: база
город: города
правка: правка правки
кызылмакташ: кызылмакташы
обсуждение: обсуждение
свежий: свежие
смотреть: см
кук: куки
код: код
косуйенка: косуйенки
куттыкожа: куттыкожа
последний: последний последняя
инструмент: инструменты
справка: справка
новый: новые
берег: берегу
страница: страница странице страницу страницы
участие: участие
её: её
элемент: элемент
агентство: агентство
широта: ш
район: район района районе
условие: условий условия
кызылординский: кызылординская кызылординской
сатымсать: сатымсай
читать: читать
запись: запись
могильник: могильнике
тип: тип
форум: форум
википедия: википедии википедия
представиться: представились
мы: нами
этот: эта
область: области область
текущий: текущие
акжол: акжол
тагискен: тагискен
село: села селе село
создать: создать
перепись: переписи
байкенже: байкенже
карточка: карточке
имя: имён
нохчийна: нохчийн
текст: текст
кодекс: кодекс
история: история
печать: печати
постоянный: постоянная
коктоба: коктобе
енбек: енбек
абдигаппар: абдигаппар
аккума: аккум
единственный: единственный
апанкак: апанкак
страна: страна
мобильный: мобильная
викидать: викиданных
такырколя: такырколь
год: года году
алфавит: алфавиту
карта: картами карте карты
аксуат: аксуат
данные: данным
энциклопедия: энциклопедии
пространство: пространства
пункт: пункт пунктах пункте пункты
аккорганский: аккорганский аккорганского
русский: русский
пожертвовать: пожертвовать
сырдарья: сырдарьи
тугискен: тугискен
доступный: доступен
томенарык: томенарык
почтовый: почтовый
каз: каз
кенести: кенес
знак: знак
источник: источник
некоммерческий: некоммерческой
человек: человек человека
учётный: учётную
событие: события
екпинди: екпинди
кашканколь: кашканколь
получить: получить
республика: республики
короткий: короткий
дополнить: дополнив
сообщество: сообщество
заявление: заявление
случай: случаях
сюда: сюда
скачать: скачать
товарный: товарный
викимедиа: викимедиа
май: мая
ответственность: ответственности
вклад: вклад
левый: левом
кандоза: кандоз
использование: использования
персональный: персональные
случайный: случайная
калгансыр: калгансыр
отредактировать: отредактирована
находиться: находится
национальный: национальной
география: география
система: системе
казахстан: казахстан казахстана казахстане
ссылка: ссылка ссылки
телефонный: телефонный
бесарыкский: бесарыкский
категория: категории
скрытый: скрытые
сведение: сведения
манап: манап
населённый: населённые
нп: нп
служебный: служебные
жанакорган: жанакорган
сообщить: сообщить
другой: других
версия: версия
беларускать: беларуская
автомобильный: автомобильный
пояс: пояс
автопростановка: автопростановкой
избранный: избранные
статистика: статистика статистике
индекс: индекс
составлять: составляло
итог: итоги
отдельный: отдельных
лицензия: лицензии
отказ: отказ
кожамбердь: кожамберди
проект: проектах
билибай: билибай
кейден: кейден
перейти: перейти
сохранение: сохранением
свободный: свободной
идентификатор: идентификаторы
сельский: сельский сельского
указание: указанием
конфиденциальность: конфиденциальности
озгент: озгент
талап: талап
связанный: связанные
навигация: навигации навигация
ранее: ранее
ещё: ещё
связаться: свяжитесь
поведение: поведения
незавершённый: незавершённые
разработчик: разработчики
кожакент: кожакент
дополнительный: дополнительные
примерно: примерно
женщина: женщин
шалкия: шалкия
изображение: изображений
это: это
жайылма: жайылма
цитировать: цитировать
архивировать: архивировано
примечание: примечания
кауык: кауык
организация: организации
цифровой: цифровые
август: августа
районный: районного
зарегистрировать: зарегистрированный
административный: административный
фонд: фонд
юг: югу
политика: политика
мочь: могут
просмотр: просмотры
неопр: неопр
править: править
