мы: нами
каликино: каликино
применять: применяемого
ясень: ясень
воронов: вороново
гришковый: гришково
кудряшовый: кудряшово
муниципальный: муниципального муниципальный
афимьяновый: афимьяново
жидкий: жидкое
кончинк: кончинка
ямник: ямники
статья: статьи статья
трошкино: трошкино
стрелечье: стрелечье
весь: вся
покров: покров
московский: московское
недоступный: недоступная недоступные
орешек: орешки
гостиница: гостиница
семёновский: семёновское
филизи: филизи
энциклопедия: энциклопедии
читатьправитьправить: читатьправитьправить
скорневый: скорнево
центр: центр центра
правкиновое: правкиновые
кострец: кострецы
поселение: поселение поселения
западинк: западинки
моложский: моложской
маланьиный: маланьино
преобладать: преобладают
закон: закон
пархово: пархово
перейти: перейти
нива: нива
широта: ш
никольский: никольский никольское
примечание: примечания
страницасодержаниеизбрать: страницасодержаниеизбранные
заречье: заречье
любятино: любятино
павловский: павловское
подсосение: подсосенье
амосино: амосино
починка: починок
максатихинский: максатихинский максатихинского максатихинском
навигация: навигации навигация
дюдьковый: дюдьково
тверской: тверской
макеевский: макеевское
перепись: переписи перепись
территориальный: территориального
элемент: элемент
страница: страница страницы
жижиный: жижино
княжевый: княжево
гоголихо: гоголиха
период: период периода
река: реки
википедия: википедии википедия
статьятекущий: статьятекущие
год: года
сельский: сельского сельское
снежный: снежный
батуриха: батуриха
статьисообществофорумсправкасвежий: статьисообществофорумсправкасвежие
перевес: перевесы
жуковца: жуковец
кузнец: кузнецы
воздвиженка: воздвиженка
молчаново: молчаново
кистутовый: кистутово
печать: печати
пункт: пунктов пункты
индекс: индекс
политика: политика
районаскрыть: районаскрытые
строкина: строкина
записьвойти: записьвойти
боровский: боровское
сутуловый: сутулово
дополнительный: дополнительные
белушиха: белушиха
заляжий: заляжье
составлять: составляет составляли
холодное: холодного
ривицкий: ривицкий ривицкое
загородие: загородье
расстояние: расстоянии
районный: районный
минк: минка
фонд: фонд
шеневый: шенево
поиск: поиск поиску
страницуполучить: страницуполучить
язык: языках
право: правом
клевцовый: клевцово
ссылка: ссылка ссылки
воздух: воздуха
новозаводский: новозаводской
направление: направлений
перечень: перечня
дубка: дубки
находиться: находится
тп: тп
март: марта
г: г
структура: структуре
трестенский: трестенская трестенское
ульяновка: ульяновка
просмотр: просмотры
население: население населения
федеральный: федеральная федеральный
максатихий: максатиха максатихи
куничих: куничиха
репинок: репинка
фофоновый: фофоново
трусовый: трусово
ссылкасведение: ссылкасведения
гундорих: гундориха
действовать: действовать
прямой: прямой
горм: горма
весёлый: веселая
кондратковый: кондратково
кочка: кочки
отказ: отказ
характеризоваться: характеризуется
событияпожертвовать: событияпожертвовать
осташиха: осташиха
температура: температура температуры
россия: россии россия
вязина: вязины
населить: населённых
тёплый: тёплого тёплый
национальный: национальной национальный
среднегодовой: среднегодовая
время: времени время
система: система
изображение: изображений
звереть: зверло
атмосферный: атмосферных
нарехово: нарехово
указание: указанием
смещение: смещение
добрыня: добрыни добрыня
ерошиха: ерошиха
лебедевый: лебедево
хомутихий: хомутиха
карельский: карельское
около: около
артеново: артеново
умеренно: умеренно
гороватый: гороватое
село: село
викимедиа: викимедиа
андрониха: андрониха
свободный: свободной
максимум: максимум
гарусовый: гарусово
киевка: киевка
континентальный: континентальный
копия: копии
старое: старое
паржа: паржа
некоммерческий: некоммерческой
горшковый: горшково
пасьмин: пасьмино
ежиный: ежино
столбиха: столбиха
горка: горка
содержание: содержание
дора: дор
страна: страна
база: база
москватверьмаксатих: москватверьмаксатиха
бора: бор
волчихов: волчихово
бачманово: бачманово
согласно: согласно
федорцевый: федорцево
выпадать: выпадает
подол: подолы
персональный: персональные
райд: райда
планирование: планирования
условие: условий условия
хвощ: хвощ
административный: административного
брод: броды
столпино: столпино
маковискать: маковищи
пальчих: пальчиха
численность: численность
больница: больница
январь: января
зареченский: зареченского зареченское
авторство: авторства
кало: кало
правкипостоянный: правкипостоянная
материал: материал
октмый: октмо
дата: дата
другой: другие других
кулачих: кулачиха
осадки: осадков
февраль: февраля
гуммаленький: гуммала
отредактировать: отредактирована
ручка: ручки
ошибкекак: ошибкекак
часовой: часовой
трестный: трестна
володарка: володарка
государственный: государственная
примерно: примерно
коноплёвый: коноплево
змеево: змеево
колодиха: колодиха
сидорковый: сидорково
клевискать: клевищи
долговый: долгово
имя: имён
антонидовый: антонидово
архивировать: архивировано
новый: новое
количество: количество
министерство: министерства
малышевский: малышевское
ребахушко: ребахушки
иванов: иванова
субъект: субъект
короткий: короткий
сокерин: сокерино
годовой: годовое
представиться: представились
коссулить: коссули
рамешок: рамешки
июнь: июня
григоровый: григорово
топальский: топальское
пояс: пояс
область: области область
тверская: тверская
учётный: учётную
топоним: топонима
бурак: бураки
этот: эта
корговый: коргово
подробный: подробнее
фгис: фгис
подмельничный: подмельничное
разработчик: разработчики
дубровка: дубровка
знак: знак
отдельный: отдельных
ситьковый: ситьково
использование: использования
хабара: хабары
лозовая: лозовая
ольховка: ольховка
дубискать: дубищи
андрианиха: андрианиха
населённый: населённые
станция: станция
плоский: плоски
великое: великое
овсяник: овсяники
ремчиный: ремчино
лукка: лукка
песогор: песогоры
труфанковый: труфанково
боровой: боровая
часть: части часть
селецкое: селецкое
оток: отока
подусовый: подусово
приказ: приказ
абсолютный: абсолютный
кузнечик: кузнечики
кедровка: кедровка
лука: луки
шорда: шорды
район: район района районе районов
нп: нп
архивный: архивной
хмелево: хмелево
русый: рус
неопр: неопр
бахарево: бахарево
сообщить: сообщить
ключёвка: ключевка
быковка: быковка
мск: мск
барсук: барсуки
кодистория: кодистория
связаться: свяжитесь
лесной: лесных
текущий: текущем
код: код
который: которых
страницецитировать: страницецитировать
ресурс: ресурсов
веселовкий: веселовка
климат: климат
мокшицы: мокшицы
саврасих: саврасиха
черниковый: черниково
малый: малая малое малый
липовка: липовка
конюшиный: конюшино
широковый: широково
малышевый: малышево
красненький: красненькое
статьяобсуждение: статьяобсуждение
течение: течение
данные: данных
ещё: ещё
сосновка: сосновка
березовка: березовка
ванькина: ванькин
медведково: медведково
викидать: викиданных
коряк: коряков
алфавитунаселить: алфавитунаселённые
мочь: могут
русский: русские русский
репища: репище
огрызковый: огрызково
зона: зон зоне
чикулихо: чикулиха
малиниха: малиниха
городок: городок
лес: лесов
человек: человек
цифровой: цифровые
мм: мм
пономарёво: пономарёво
день: дней
годувикипедия: годувикипедия
заглавный: заглавная
больший: большая
данилковый: данилково
найдёниха: найдёниха
труженик: труженик
поведение: поведения
кук: куки
колодино: колодино
николаевский: николаевское
селец: сельцы
труженицкий: труженицкое
статистика: статистика
история: история
ковыркова: ковыркова
ривица: ривица
тельцово: тельцово
посёлок: посёлок
юреневый: юренево
последний: последний последняя
курилихо: курилиха
зараменье: зараменье
текст: текст
километр: километров
плотник: плотники
заявление: заявление
тимонино: тимонино
мобильный: мобильная
править: править
мотуново: мотуново
сюдасвязанный: сюдасвязанные
ответственность: ответственности
западный: западного
кондушка: кондушка
соснушко: соснушка
жук: жуки
атемежа: атемежа
зандровый: зандровой
бережок: бережки
кодекс: кодекс
версия: версия
дымцевый: дымцево
зубачих: зубачиха
категория: категории
лощемль: лощемля
май: мая
зарайский: зарайское
деревнякулачиха: деревнякулачиха
житник: житники
инструмент: инструменты
цаплиный: цаплино
фомин: фомино
предел: пределах
системеобсуждениевкладсоздать: системеобсуждениевкладсоздать
паулинский: паулинские
тип: тип
карта: картами карты
план: план
койвушко: койвушка
гора: гора горы
зародович: зародовичи
лицензия: лицензии
иваньковый: иваньково
почтовый: почтовый
пространство: пространства
хмелевой: хмелевая
раевский: раевское
минимум: минимум
страницыслужебный: страницыслужебные
заручей: заручье
горячево: горячево
поповка: поповка
воробьёвый: воробьёво
большой: большое большой
география: география
коммуна: коммуна
туберкулёзный: туберкулезная
конфиденциальность: конфиденциальности
красивый: красивый
красный: красная
информационный: информационная
бык: быки
каменка: каменка
фабрика: фабрика
смотреть: см
пирожковый: пирожково
состав: состав
деревковый: деревково
нохчийна: нохчийн
окато: окато
ермолин: ермолино
луначарский: луначарское
малиновка: малиновка
ключевой: ключевая
утверждение: утверждении
бурачих: бурачиха
луг: луг
малёк: малька
афанасовый: афанасово
идентификатор: идентификаторы
глебездовый: глебездово
красухой: красуха
преображение: преображение
оран: ораны
хутор: хутор
город: города
товарный: товарный
генеральный: генеральный
толоцкий: толоцкое
зарегистрировать: зарегистрированный
значение: значения
городской: городского
наташин: наташино
пятницкий: пятницкое
дубовик: дубовика
округ: округа
фенюшиха: фенюшиха
засека: засека
низина: низины
всероссийский: всероссийская
скирка: скирки
относительно: относительно
столоповый: столопово
карел: карелы
исчисление: исчислении
маслёнка: масленка
результат: результатам
лом: ломы
юхово: юхово
статьислучайный: статьислучайная
безморозный: безморозный
асташиха: асташиха
длиться: длится
ветер: ветры
березуга: березуга
ступник: ступники
лукьяново: лукьяново
спичих: спичиха
доступный: доступен
святовский: святовское
организация: организации
хмелёвка: хмелевка
природный: природных
кожиный: кожино
скачать: скачать
викиданныхвикипедия: викиданныхвикипедия
кулаковый: кулаково
будёновка: будёновка
б: б
случай: случаях
площадь: площадь
паулино: паулино
антипковый: антипково
тифина: тифины
стыковый: стыково
проект: проектах
российский: российской
слепниха: слепниха
деревня: деревня
ветролом: ветроломы
селискать: селищи
сохранение: сохранением
обращение: обращения
астафьево: астафьево
федерация: федерации
статус: статус
описание: описание
участие: участие
вышка: вышка
железнодорожный: железнодорожная
хребтовый: хребтово
прудовица: прудовицы
острый: острые
ивановский: ивановское
бараниха: бараниха
входить: входит
ферезный: ферезна
держаться: держится
деревняпро: деревняпро
алферих: алфериха
источник: источник источниками
шапкино: шапкино
правка: правка
гористый: гористое
доненский: доненский
райдино: райдино
лесорастительный: лесорастительных
райковый: райково
берег: берегу
рыбинский: рыбинское
