войти: войти
описание: описание описанию описания
веление: веление
авторство: авторства
опус: опус
федеральный: федеральный
материал: материал материалов
журнал: журнал
юстиция: юстиции
глаз: глазами
детектив: детектив детектива
повод: поводу
поиск: поиск поиску
внешний: внешние
инструмент: инструменты
гафар: гафар
страница: страница странице страницу страницы
значительно: значительно
считать: считаю
имя: имени имён
обращение: обращения
азербайджан: азербайджан азербайджана
тип: тип
представиться: представились
современник: современников
ноябрь: ноября
автор: автор авторы
текст: текст тексты
политик: политик политиков
экстремистский: экстремистским экстремистских
кодекс: кодекс
иначе: иначе
указать: указан
испанский: испанский
опубликовать: опубликованный
написать: написанный напишет
гражданство: гражданство
язык: язык языками языках
солдат: солдат солдатами
вымышленный: вымышленное
событие: события
учёный: учёных
оглы: оглы
писатель: писателей писатели писатель писателях
случай: случаях
достоверный: достоверный
отличаться: отличаться
поддаваться: поддающийся
источник: источник источники источников
скандальный: скандальными
ресурс: ресурсы
фронтовой: фронтовой
суд: судом
народ: народа
статья: статье статьи статью статья
издать: издана
скрытый: скрытые
служебный: служебные
сепаратизм: сепаратизм
условие: условий условия
версия: версии версия
критиковать: критикуют
перейти: перейти
жанр: жанр жанре
связаться: свяжитесь
социологический: социологической
правка: правки правок
архивировать: архивировано
саранск: саранска
март: марта марте
кавказец: кавказцев кавказцы
фонд: фонд
творить: творимых
мочь: могут можете
сайт: сайтах сайте
навигация: навигации навигация
журналистка: журналисткой
многий: многих
переписка: перепиской
непустой: непустое
наука: наук
октябрь: октября
заглавный: заглавная
рекомендация: рекомендации
кгб: кгб
публицистика: публицистика публицистики
содержание: содержание
баку: баку
код: код
заменить: заменить
известный: известных
негативно: негативно
день: дней
прозаик: прозаик
этот: эта
авторитетный: авторитетные
относиться: относится
резко: резко
рф: рф
список: список
азербайджанский: азербайджанский
габараев: габараевым
дело: дело
экстремизм: экстремизм
год: года году
алфавит: алфавиту
федерация: федерации
русский: русский русского
пожертвовать: пожертвовать
интернет: интернете
гасанов: гасанов гасанова гасанове
он: нём
отечественный: отечественной
русскоязычный: русскоязычный
родиться: род родившиеся
место: место
борис: борисом
некоммерческий: некоммерческой
письмо: письма
сообщество: сообщество
заявление: заявление
май: мая
ответственность: ответственности
сергеевич: сергеевич
диалог: диалоги
персональный: персональные
отредактировать: отредактирована отредактировать
союз: союза
система: системе
собор: собор собора
проверка: проверки
ссылка: ссылка ссылки ссылок
представлять: представляет
больший: большую
человек: людях человек
сообщить: сообщить
произведение: произведений произведения
избранный: избранные
википедия: википедии википедия
ссср: ссср
проверить: проверенной
лицензия: лицензии
называть: называют
пархоменко: пархоменко
свободно: свободно
делать: делал
самиздат: самиздат
деятель: деятель
цитироваться: цитируется
ещё: ещё
первый: первый
данный: данный
районный: районным
турецкий: турецким
неопр: неопр
править: править
действовать: действовать
подробный: подробнее
содержаться: содержатся
война: войне
ошибка: ошибке
получить: получил получить
обсуждение: обсуждение
кук: куки
вспомнить: вспомню
владимир: владимиром
великий: великой
участие: участие
известность: известность
книга: книг книга книги
сам: сами
название: названием названий
запись: запись
форум: форум форумах
пробежать: пробежал
цветной: цветные
создать: создать
фальшивка: фальшивка
край: край
печать: печати
опасный: опасная
постоянный: постоянная
архив: архива
викидать: викиданных
пространство: пространства
неоднозначный: неоднозначного
утверждение: утверждениями
знак: знак
денишевый: денишевой
кандидат: кандидат
товарный: товарный
шаблон: шаблон
сюда: сюда
скачать: скачать
оригинал: оригинала
вклад: вклад
требовать: требуют
время: времен времени время
оккупировать: оккупированных
опытный: опытными
подать: подано
явно: явно
сведение: сведения
публицист: публицист
другой: других
кавказ: кавказа
английский: английский английским
совместно: совместно
свихнуться: свихнувшийся
михаил: михаил
июнь: июня
тема: темы
зверство: зверств
сноска: сносок
такой: такое
значение: значение
затрагивать: затрагивает
интервью: интервью
эльчин: эльчин эльчина эльчине
цитировать: цитировать
технический: технических
хватать: хватает
зарегистрировать: зарегистрированный
махнуть: махнул
политика: политика политику
мордовия: мордовия
отставной: отставной
просмотр: просмотры
москва: москве
рождение: рождения
член: член
проверять: проверяема
высказаться: высказался
себя: собой
участник: участниками
сентябрь: сентября
биография: биографии
крайне: крайне
правильно: правильно
город: города
содержать: содержащие
свежий: свежие
смотреть: см
викитека: викитеку
справка: справка
прокуратура: прокуратуру
новый: новые
раскрытие: раскрытие
проверяться: проверялась
элемент: элемент
читать: читали читать
мы: нами
нацист: нацисты
текущий: текущая текущие
добавить: добавив
территория: территориях
республика: республика
история: история
философский: философские
карина: кариной
издевательство: издевательств
мобильный: мобильная
ленинский: ленинским
неуважительно: неуважительно
энциклопедия: энциклопедии
творчество: творчестве
деятельность: деятельности
министерство: министерством
доступный: доступен
документ: документ
занятие: занятий
учётный: учётную
бакинский: бакинский
короткий: короткий
признать: признан
викимедиа: викимедиа
горбачёв: горбачёв
использование: использования
гражданский: гражданский
случайный: случайная
революция: революции
нормальный: нормальный
пока: пока
удалить: удалена
включить: включен
офицер: офицер
персоналия: персоналии
владеть: владеет
категория: категории
информация: информация
фамилия: фамилией
президент: президент
фиксация: фиксации
отдельный: отдельных
отказ: отказ
проект: проектах
свободный: свободной
многое: многое
вов: вов
указание: указанием
сохранение: сохранением
конфиденциальность: конфиденциальности
свой: своем
связанный: связанные
дата: дата
поведение: поведения
обособление: обособления
должный: должна
разработчик: разработчики
вид: виде
дополнительный: дополнительные
традиция: традициям
остросоциальный: остросоциальные
изображение: изображений
это: это
последний: последний
примечание: примечания
организация: организации
российский: российской
профессор: профессором
военный: военных
статистика: статистика
