черта: черта черте черты
крепостной: крепостной
желудок: желудка
симбирсити: симбирсити
начало: начала начале началом
донесение: донесению
пустить: пущена
беловодье: беловодье
посетить: посетил
самсонов: самсонова
всероссийский: всероссийская
новый: новая новое новые новый
журнал: журнал
родник: родник родники
сухой: сухой
впоследствии: впоследствии
герой: герой
скончаться: скончался
полоска: полоску
найтись: нашлись
произвести: произвела
владелец: владелец
несмотря: несмотря
найти: найти нашло
прекращение: прекращения
масса: масса
комаровка: комаровка
область: области область
домашний: домашние домашних
туризм: туризм
стать: стал стали стало
покров: покрова
расположение: расположения
особый: особый особых
сословие: сословие
посёлок: посёлки
спб: спб
илюшин: илюшин
суконный: суконная суконной суконную
симбирский: симбирская симбирские симбирский симбирским симбирского симбирское симбирской
карсунский: карсунская карсунский карсунского карсунской
святой: святой святые
оно: оно
церковь: церквей церкви церковь
деньга: деньги
переслать: перешли
случай: случаях
село: села селе село селом
кузнецов: кузнецов кузнецова кузнецову кузнецовыми кузнецовых
снизить: снизил
николай: николай николая
россия: россии россия
путеводитель: путеводитель
белозерский: белозерским
октмый: октмо
войти: войти вошло вошёл
водопровод: водопровод
пленный: пленных
огласка: огласку
век: вв века
приезжать: приезжала
являться: являлись являлся
теньковка: теньковка
чудо: чудеса
крупный: крупное крупные крупных
война: войне войну войны
земля: земли земля
фабрикант: фабриканта
сельский: сельский сельское сельском
егоров: егоров
развиваться: развиваться
купеческий: купеческий купеческое
имение: имение
архивировать: архивировано
барыш: барыш
выселить: выселил
пролиться: пролилось
крестьянин: крестьян крестьянам крестьянина
фонд: фонд
святитель: святителя
арендный: арендное
вход: входа
сражение: сражение сражений
раздельный: разделен
состав: состав
контур: контур
перепись: перепись
прохват: прохваты
губерния: губернии губерний губернию губерния
проехать: проехать
февраль: февраля
общий: общ общей общим
половина: половине
присвоить: присвоенные
вскоре: вскоре
ответ: ответ
епархия: епархии
э: э
корень: корни
широта: ш
значение: значение значения
иркутск: иркутске
завод: завод заводе
этот: эта
освободить: освобожденных
сосредоточиться: сосредоточились
правка: правка правки правок
ферма: фермах
безлошадный: безлошадным
оказаться: оказался
сельскохозяйственный: сельскохозяйственной
крс: крс
отряд: отрядами
дело: дел дела дело делу
котельная: котельная
опытный: опытными опытных
знать: знал
обоз: обоз обозе
рубый: рубо
мельница: мельница мельнице
вор: воров
жильё: жилья
базарный: базарный
федерация: федерации
действовать: действовали действовать
ручной: ручные
превратить: превратить
христов: христова
импульс: импульс
занятый: занята
сообщество: сообщество
заявление: заявление
росток: ростки
персональный: персональные
литература: литература
работать: работало работают работающих
телефонный: телефонный
тот: тех той
малый: малая малое
конец: конец
человек: людей человек человека
каменный: каменная каменный каменными
больший: большая большие большими
произведение: произведений
википедия: википедии википедия
жалоба: жалоба жалобе
который: которое которой котором которую которые который которым
пластмассовый: пластмассовых
центр: центр центре центром
распоряжаться: распоряжаться
ещё: ещё
областной: областную
шерстяной: шерстяной
разинец: разинцев
зажиточный: зажиточного
маслосырзавод: маслосырзавод
русский: русская русские русский русских русского русском
рабочий: рабочие рабочий рабочим рабочих
прислониха: прислониха
писать: писали
уроженец: уроженцы
конный: конный конных
неопр: неопр
памятник: памятник памятники
служить: служил служить
рак: рака
хороший: лучших
декабрь: декабря
семья: семей семьями
ручей: ручьи
труп: трупами
центральный: центральной
проходить: проходил проходит
москва: москва москву
относиться: относились
стефан: стефана
каша: кашу
ведомость: ведомостям
белозерье: белозерье
участие: участие
погореловый: погорелово
двухэтажный: двухэтажный
прут: прутьями
октябрь: октябре октября
перестроить: перестроил
поле: поле полях
двухквартирный: двухквартирными
возраст: возрасту
ростислаевка: ростислаевка
взять: взявшие взял
устереньский: устереньская
татарский: татарская татарские
имя: имя имён
аничков: аничков
пользование: пользование
тракт: тракт тракта тракту
постоянный: постоянная
минеральный: минеральные
богородица: богородицы
самара: самара
советский: советского советское
воспитатель: воспитателя
фабрика: фабрика фабрике фабрики фабрикой фабрику
полный: полное
изнурённый: изнурённые
страх: страх
знак: знак
окрестность: окрестностях
галерея: галерея
продать: продал
хлеб: хлеб хлеба
южный: южнее
дракон: драконы
армейский: армейского
источник: источник источниками источники
отделение: отделение отделением
кротков: кротковыми
произойти: произошло
обнаружить: обнаружил
каменистый: каменистого
другой: другие других
совместно: совместно
получить: получила получило получить
закрепиться: закрепившееся
провиант: провиантом
пряжа: пряжи пряжу
июнь: июня
песня: песни
житель: жителей жители
семёнов: семенова
избить: избил
вернуть: вернул
варакин: варакин
хватать: хватает
политика: политика
окато: окато
симбирск: симбирск симбирска
уезд: уезд уезда
статья: статьи статья
плата: плату
христорождественский: христорождественской
ульяновск: ульяновск ульяновска ульяновске
комната: комнату
отечество: отечества
отделять: отделяя
язык: язык языках языком
районный: районный
например: например
культурный: культурного культурное
называться: называлось называться
устьуренец: устьуренцев
около: около
установить: установил установили
энциклопедия: энциклопедии энциклопедия
один: одной одном
организоваться: организуется
мобильный: мобильная
красный: красный
доступный: доступен
саранск: саранск
приказ: приказу
мир: мир
столько: столько
григориевич: григорьевич
учётный: учётную
короткий: короткий
викимедиа: викимедиа
александровка: александровка
выстроить: выстроенный
богатый: богатых
расхититель: расхитители
немедленно: немедленно
книга: книга книгу
питание: питание
потечь: потекли
станок: станки
ход: ход
иметься: имеются
описаниесобор: описаниесоборов
основать: основал основан основанные основано
ввиду: ввиду
рубеж: рубежей
база: базе
отказ: отказ
нанять: найму
сохранение: сохранением
связанный: связанные
кирпичный: кирпичный
зависимость: зависимости
московский: московский московского московскому
дополнительный: дополнительные
савицкий: савицкого
осада: осады
измученный: измученные
большой: большое
август: августа
дьяк: дьяка
товар: товар товаром
земледелие: земледелие
средний: среднее средняя
мобилизация: мобилизации
новобарышский: новобарышская
волость: волости
татарча: татарча
репей: репьёв
продажа: продажу
великий: великий великой великую
государственный: государственном
лишь: лишь
постройка: постройки
охрана: охране охраны
добрынин: добрынин
поиск: поиск поиску
коммуналка: коммуналка
инструмент: инструменты
стиль: стиле
очередной: очередной
страница: страница странице страницу страницы
уренск: уренск
фольклорист: фольклорист
название: название названии названия
честь: честь
хозяин: хозяева хозяин
предприятие: предприятия предприятиях
берег: берег берегу
долина: долины
париж: париж
богомолье: богомолье
наш: нашего нашей нашему нашим
бедствовать: бедствовала
потребовать: потребовали
машина: машины
односельчанин: односельчанам
тыс: тыс
создаваться: создаются
забастовка: забастовки забастовку
отличаться: отличается отличаться
остаток: остатками
сурожский: сурожского
волостной: волостного волостное волостной волостным
скрытый: скрытые
население: население населения
власть: власти
г: г
руководство: руководством
бывший: бывшем бывшие
егершельда: егершельде
князь: князей князю князя
главный: главный главным
сеять: сеют
идентификатор: идентификаторы
поимённо: поимённо
храм: храм храме храмов
казнить: казнили
разыскаться: разыскался
германия: германией
обелиск: обелиск
связаться: свяжитесь
викигид: викигид
натужно: натужно
викидать: викиданные викиданных
пригород: пригород
колхоз: колхоз колхоза
содержаться: содержалось
улправда: улправда
наблюдать: наблюдали
усадьба: усадьба усадьбы
родственник: родственниками
мочь: могут
поволжье: поволжье
мужской: мужского
купить: купившего
зарплата: зарплата зарплату
отсутствие: отсутствие
местный: местные местных
первый: первой
стефанович: стефановича
автомобильный: автомобильная
барятинский: барятинский барятинских барятинского
наследие: наследие наследия
федеральный: федерального
устой: устоев
правление: правление правления
расположить: расположен расположено
безусловный: безусловную
жестоко: жестоко
украшение: украшения
управление: управление
настольный: настольная
царь: царю царя
думный: думного
прибыть: прибывших
репин: репина
полка: полку
мемуары: мемуарах
мученица: мученицы
пять: пять
отредактировать: отредактирована
география: география
активный: активное
организовать: организовано организованы
красильный: красилен
ссылка: ссылка ссылки
устроить: устроить
населённый: населённые
занести: занесены
объект: объектов объекты
корова: коров
гкгна: гкгн
кандарать: кандарать
лицензия: лицензии
расписание: расписании
стихия: стихии
таможенный: таможенных
этика: этику
фабричный: фабричного фабричному
известный: известные известный
следующий: следующие
разрушить: разрушили
рукав: рукавов
дорога: дорога дорогу
сложность: сложности
подступить: подступил
еда: еду
солома: соломой
мясо: мясом
котяковский: котяковский котяковского
издательский: издательский
специальный: специальная
магазин: магазина
губернатор: губернатора губернатору
подробный: подробнее
ошибка: ошибке
глава: главе
владимир: владимир
войско: войсками войском
именьковский: именьковская
последний: последний последняя
частный: частный
собирать: собирал
улица: улиц улица улицах
задерживать: задерживать
азов: азов
город: города городов
столовый: столовых
художник: художник
ивановский: ивановский
край: край
печать: печати
ульянов: ульянов
пугачёв: пугачёва
григорий: григорий
локальный: локальное
эмигрант: эмигранты
трёхшубин: трёхшубиным
карсуна: карсуна карсуне
таволжанка: таволжанка
дмитрий: дмитрий
необходимый: необходимые
казанский: казанской
попадать: попадают
белый: белую
пресвятой: пресвятой
кроме: кроме
частично: частично
воровской: воровским
собранный: собранные
артель: артель
михаилович: михайлович
требовать: требуют
воспоминание: воспоминаниям
так: т
комиссия: комиссия
отражать: отражает
устилать: устилали
появиться: появилась появилось появился
длиться: длится
кореец: корейцы
победа: победа
песок: пески
собака: собаки
языковый: языково
дом: дом дома домами доме
хлопковый: хлопковой
кон: кон
западный: западнее
пайщик: пайщиков
грязнуха: грязнуха
июль: июль июля
указ: указа указом
отечественный: отечественной отечественную
остроговый: острогов
это: этим это
гора: горы
пройти: прошли прошло
наивный: наивного
хозяйство: хозяйств хозяйство
техника: техники
картавенко: картавенко
языковский: языковский
ульяновский: ульяновская ульяновский ульяновской
послать: посланной
северный: севернее
просмотр: просмотры
указанный: указанного
затем: затем
сборник: сборнике
ремень: ремней
широко: широко
агафий: агафия
послевоенный: послевоенные
промысл: промыслы
погибнуть: погибли
выпуск: выпуску
проживать: проживающего
священник: священником
работа: работа работы
март: марте
элемент: элемент
реформа: реформы
протест: протесты
акад: акад
читать: читать
вести: вести
курганный: курганная
сын: сыновья
колесо: колёса
др: др
общеобразовательный: общеобразовательная
история: истории история
ткач: ткача ткачи
разыскать: разыскал
сельчанин: сельчан
женский: женский
пост: пост
ткацкий: ткацкие ткацкую
карсун: карсун
стрелецкий: стрелецкая
сукно: сукна
бунтовщик: бунтовщиками
ценина: ценины
горенка: горенки
участок: участок
сосновка: сосновка
медянский: медянский
случайный: случайная
пока: пока
отступать: отступавшими
бой: бой
сдк: сдк
шейн: шейн
меловой: меловые
конвой: конвоем
совхоз: совхоз совхоза совхозе
помощь: помощь помощью
конфиденциальность: конфиденциальности
нагаево: нагаево
дата: дата
особенность: особенность
корпус: корпус
голик: голике
несколько: несколько
почтовый: почтовое почтовый
собраться: собравшиеся собрались
расценка: расценки
организация: организации организация
посильный: посильную
однако: однако
площадь: площади
пожарный: пожарных
статистика: статистика
друг: другом
курган: курган
сказитель: сказителей
женщина: женщины
ополчение: ополчение
типолитогра: типолитогр
слияние: слияния
принадлежать: принадлежавшие принадлежала принадлежало
учёт: учёте
обращение: обращения
район: район района
временной: временного
совет: советы
ковёр: коврами
нераспознанный: нераспознанным
зотов: зотова
учреждение: учреждении
трудиться: трудились
указать: указан указано
ертоулом: ертоулом
купец: купец купцу
апрель: апреля
осип: осип
рождественский: рождественское
крестьянский: крестьянских крестьянской
веялка: веялки
подмести: подмести
здание: здания
разбогатеть: разбогатевших
партизан: партизан
слобода: слобода слободы
сост: сост
ермак: ермаки
побить: побил
суглинистый: суглинистого
тальский: тальского
заполнить: заполнить
щи: щи
придорожный: придорожное
уренский: уренский
служебный: служебные
условие: условий условия
индекс: индекс
расслоение: расслоение
насытиться: насытился
садка: садок
челобитчик: челобитчики
располагаться: располагалось располагался
степан: степана
утехина: утехина
помещик: помещика
наслать: нашли
образовать: образованного
второй: второй
кошелёвка: кошелевка
народный: народное народные
администрация: администрации
лавинский: лавинского
образоваться: образовалось
создать: создана создать
навигация: навигации навигация
взбунтоваться: взбунтовались
склад: складах
год: гг год года году годы
ежемесячно: ежемесячно
статистический: статистическое
заглавный: заглавная
содержание: содержание
устроенный: устроенная
пропасть: пропал
жаловаться: жаловались
уренска: уренска
живописный: живописные
опустеть: опустевшие
пожертвовать: пожертвовать
краеведческий: краеведческий
пункт: пункт пункте пункты
некоммерческий: некоммерческой
самокиш: самокиш
представлять: представляют
система: системе
штраф: штрафы
поп: попа
кавалерийский: кавалерийскому
крыша: крыше
нп: нп
вальцевой: вальцевая
субъект: субъект
пояс: пояс
дворянский: дворянские
байкпост: байкпост
предприниматель: предприниматели
уверенный: уверен
захаров: захаров
приходский: приходских
лука: лукой
мужик: мужики
иена: иен
избрать: избран
бумажный: бумажная
вновь: вновь
прочный: прочные
править: править
берёзовый: берёзовый
часовой: часовой
пётр: петра пётр
ламанский: ламанского
режим: режим
блог: блог
статус: статус
чёрный: чёрная
обсуждение: обсуждение
муниципальный: муниципальный
преобразоваться: преобразовалась
гнилой: гнилым
моном: мономах
средство: средства
нохчийна: нохчийн
начинать: начинает
жилой: жилой
страна: страна
волжский: волжского волжское
дворянин: дворянами
казак: казаков
иринарх: иринарх
котяковый: котяково
везти: везли
выплачиваться: выплачивается
туроператор: туроператор
семёнович: семёнович
торговый: торговый
товарный: товарный
сюда: сюда
вклад: вклад
китаец: китайцы
устерень: устерень
постный: постным
открытый: открытый
объявить: объявили
придел: приделе
луговой: луговой
бунтовать: бунтовали
ученик: ученик
фронт: фронт
лавка: лавок
культура: культура культуры
выручать: выручала
группа: группа
зарегистрировать: зарегистрированный
материя: материю материя
написать: написал
казённый: казённый
узнать: узнав
собор: соборов
царский: царским
рождество: рождества
основный: основная основными
баженов: баженов
участник: участниками
карпов: карповы
детсад: детсада
инфраструктура: инфраструктура инфраструктурой
свежий: свежие
красносурский: красносурское
вальдиватский: вальдиватское вальдиватском
голышёвка: голышевка
мы: нами
погибший: погибшим
текущий: текущая текущие
компас: компас
время: время
никитино: никитино
лошадь: лошадьми
предел: пределом
мануфактура: мануфактура мануфактуре
заводчик: заводчика
интерес: интерес
ходить: ходят
оказывать: оказывали
кованый: кованые
устьуренц: устьуренцы
чернозём: чернозёма
нач: нач
краснополк: краснополка
спрос: спрос
фольклорный: фольклорных
есть: едят
формироваться: формировавшемуся
некогда: некогда
фасад: фасадом
артельный: артельное
павлов: павлов
версия: версии версия
праздничный: праздничных
принять: приняли
категория: категории
неутешить: неутешимую
май: мае
отдельный: отдельных
идти: шедших
изделие: изделий
указание: указанием
владение: владение
цех: цехах
поведение: поведения
родиться: род
революционный: революционной
день: день дней
занятие: занятиями
примечание: примечания
плохой: плохое
покорность: покорность
молотилка: молотилки
прошлый: прошлом
открываться: открывается
жить: жил
сурский: сурского сурское
количество: количество
описание: описание
авторство: авторства
чудотворец: чудотворца
материал: материал материалы
председатель: председателем
распорядитель: распорядителем
урень: урень
прежний: прежние
предводитель: предводителя
значительно: значительно
гол: голов
престол: престол престолов
также: также
делать: делали
докладывать: докладывал
хлопоты: хлопотами
масло: маслом
шейный: шейном
служба: службу
представиться: представились
плотный: плотная
особенно: особенно
ноябрь: ноября
шестой: шестой
текст: текст
кодекс: кодекс
маслов: маслова
изъявить: изъявили
ред: ред
ворошилов: ворошилова
событие: события
приличный: приличный
связь: связи
час: часов
место: места месте место
число: числе
винокуренный: винокуренном винокуренный
левый: левом
пушка: пушек
рыбалка: рыбалка
спасаться: спасаясь
захватить: захватил
весь: весь всей
сходный: сходную
правительственный: правительственными
достопримечательность: достопримечательности
перейти: перейти
четыре: четыре
пополам: пополам
снова: снова
некоторый: некоторые
производство: производство
стилизовать: стилизованные
десять: десять
кадышевый: кадышево
экскурсия: экскурсий
путь: путь
быстро: быстро
создание: создание
поселение: поселение поселении
код: код кода
состоять: состояли состоят
изд: изд
армия: армии
плач: плач
сила: силы
её: её
товарищество: товарищества товарищество
полнота: полноту
мобилизационный: мобилизационном
серый: серого
потьма: потьма
алфавит: алфавиту
численность: численность
харбин: харбине
андреевич: андреевич
данные: данным
он: нём
предоставить: предоставило
асфальт: асфальт
ответственность: ответственности
керосин: керосином
развитие: развития
кровь: крови
союз: союза
географический: географическое
посвятить: посвящённый
проверка: проверки
луковский: луковский
победитель: победителя
сообщить: сообщить
варить: варят
наличность: наличность
избранный: избранные
решить: решил
проверить: проверенной
приводной: приводных
практически: практически
перевод: перевода
фёдор: фёдором
наместничество: наместничества
цифровой: цифровые
вместе: вместе
полиция: полиции
км: км
регион: регион
сад: сад
александр: александра
сохраниться: сохранившейся
кук: куки
рука: руках
река: рек реке реки
номер: номер
брат: братья
церковный: церковных
запись: запись
отражение: отражение
форум: форум
ужесточиться: ужесточился
термы: термы
закрытый: закрыты
станичный: станичное
детский: детский
пространство: пространства
память: памяти
увезти: увезя
остановиться: остановилось
объединиться: объединились
часть: часть
скачать: скачать
карта: картами
комсомольский: комсомольская
построить: построена
заволжье: заволжье
печь: пекут
говорить: говорило
монастырь: монастырей
нравственный: нравственных
высокий: высокие
девриена: девриена
хлебокомбинат: хлебокомбинат
сведение: сведения
посчастливиться: посчастливилось
природный: природные
сарай: сарай
приложение: приложение
борок: борок
платный: платная
знамя: знамени
государство: государства
русый: рус
пруд: пруд пруду
сотня: сотней
секретный: секретная
мировой: мировой
уразовка: уразовка
цитировать: цитировать
петрович: петрович
вырабатываться: вырабатывалась
нижний: нижнее
выходной: выходных
дождь: дождя
смотреть: см
усилить: усилил
справка: справка
проверяться: проверялась
крыльцо: крыльца
мельников: мельников
месяц: месяцев
школа: школа
командование: командованием
опубликовать: опубликованы
инспекция: инспекцией
покупать: покупает
старый: старом
производственный: производственный
громов: громова
раз: раза
половинный: половинное
епархиальный: епархиальным
уйти: ушли
рынок: рынок
сытина: сытин
свойство: свойство
труд: труд
тысяча: тысяч
разин: разина
десятина: десятин
рядом: рядом
свой: своих
использование: использования
праздник: праздников
димитровград: димитровград
першина: першины
конезавод: конезавода
изображение: изображениями
начаться: началось
применяться: применялся
проект: проектах
свободный: свободной
купель: купели
кроткова: кроткова
разработчик: разработчики
земляк: землякам
лебедь: лебеди
дорожный: дорожная
ранний: раньше
январь: января
насчитываться: насчитывалось
фольклор: фольклор
член: членов
