мы: нами
биобиблиографический: биобиблиографический
критика: критика критики
повесть: повесть
литературоведение: литературоведение
управление: управлении
лоза: лозами
кандидат: кандидат
ваяние: ваяния
дувакин: дувакина
мальчик: мальчик
семья: семье семья
опубликовать: опубликовал опубликованного опубликовано опубликованы
андрей: андрея
дочь: дочь
песня: песнь
публикация: публикациям публикациями
вертоградарить: вертоградари
ред: ред
якобы: якобы
использовать: использующие
источник: источник источниками источники
выступить: выступил
московский: московского московское московском
похоронить: похороненные
мемуарный: мемуарным
алфавитуписатель: алфавитуписатели
мара: мар
статья: статьи
россиилитературный: россиилитературные
энциклопедия: энциклопедии энциклопедия
аксёнов: аксёнов аксёнова
предреволюционный: предреволюционных
шахматный: шахматное
продолжение: продолжения
возвращение: возвращения
художник: художник
классический: классическая классических классической
версияправитьправить: версияправитьправить
математический: математических
сочинение: сочинений сочинения
статский: статского
издатель: издатель
статистический: статистическом
написать: написал
правкиновое: правкиновые
юрлов: юрлов
любовь: любовь
журнал: журнала журнале
лирика: лирика лирики
ресурс: ресурсы
деятельность: деятельности
литературный: литературная литературные литературный литературных
образование: образование
сборник: сборник сборниках сборников
перейти: перейти
кочевать: кочующих
интересный: интересные
примечание: примечания
статистика: статистик статистика
страницасодержаниеизбрать: страницасодержаниеизбранные
современный: современные современный
инвест: инвест
постоянный: постоянных
молодой: молодым
ударение: ударений
археологический: археологического археологическом
навигация: навигации навигация
ассирийский: ассирийский
павлович: павлович павловича павловна
страница: страница страницы
руководство: руководством
отличаться: отличаться
библиотека: библиотеки
незадолго: незадолго
википедия: википедии википедия
годуумерший: годуумершие
статьятекущий: статьятекущие
сссрпопуляризатор: сссрпопуляризаторы
год: год года годах годов году годы
статьисообществофорумсправкасвежий: статьисообществофорумсправкасвежие
архив: архив
выпустить: выпустило
чиновник: чиновника
родиться: род родившиеся родился
поэзия: поэзии поэзия
печать: печати печать
скат: скатов
жена: жена
два: две
первый: первая первого первых
политика: политика
показывать: показывают
изучать: изучал
наука: наук науки
волшебный: волшебные волшебный
принадлежать: принадлежат
поэт: поэт поэта поэты
ряд: ряд
записьвойти: записьвойти
вскрыть: вскрыв
дополнительный: дополнительные
издать: издал
сочетать: сочетает
россиипоэта: россиипоэты
россиирусский: россиирусские
мизантроп: мизантропов
жизнь: жизни
параллельно: параллельно
ритм: ритма
пастернак: пастернак пастернака
писательница: писательница
фонд: фонд
лето: лето
краткий: краткая
книга: книг книга книги книгу
мистифицировать: мистифицированного
борис: борис
поиск: поиск поисках поиску
страницуполучить: страницуполучить
полтора: полтора
борисоглебский: борисоглебская
язык: язык языках
интерес: интересов
том: томах
кокчетать: кокчетав
авторский: авторских
заниматься: занимался
россииматематика: россииматематики
галагай: галагай
могила: могилы
империилитературный: империилитературные
март: марта
неизвестный: неизвестная
хлебников: хлебникове
резка: резок
каталог: каталогах
просмотр: просмотры
свой: своими своих своём
так: т
роман: романа
заполнить: заполнил
футурист: футуристов
сын: сын
художественный: художественная
искусство: искусства
архивный: архивная
ссылкасведение: ссылкасведения
альманах: альманахах
исследователь: исследователи
действовать: действовать
оба: оба обе
мистификация: мистификацию
внешний: внешние
отказ: отказ
училище: училища училище
событияпожертвовать: событияпожертвовать
сссрписатель: сссрписатели
пушкин: пушкина
трёхсложник: трёхсложниках
раскин: раскина
алфавитурусский: алфавитурусские
сослан: сослан
проверка: проверки
общество: общество
найти: нашедший
алфавитуматематика: алфавитуматематики
время: время
разный: разными
советник: советника
век: век века
указание: указанием
сей: сей
марина: марина
этот: эта этих
продолжать: продолжал
гаспар: гаспаров
александрович: александровна
экз: экз
около: около
неоднократно: неоднократно
институт: институте
группа: групп группу
викимедиа: викимедиа
читатьтекущий: читатьтекущая
посвятить: посвятил
свободный: свободной
размер: размерах
мусагет: мусагет
стилизовать: стилизуя
российский: российская российской
некоммерческий: некоммерческой
автобиографический: автобиографическая
содержание: содержание
стихотворец: стихотворца
декабрь: декабря
некрополист: некрополистов
велимир: велимире
революция: революции революция
методика: методику
саморазоблачение: саморазоблачением
раиса: раиса
репрессировать: репрессирован
писать: писала писать
персональный: персональные
центрифуга: центрифуга центрифуги
ргб: ргб
участвовать: участвовал
условие: условий условия
зачинатель: зачинателей
москва: москва
бобров: боброва боброве боброву
также: также
колмогоров: колмогоровым
николай: николай
стиховеда: стиховед
зрение: зрения
лир: лир лира
алфавитулитературный: алфавитулитературные
важный: важные
словарь: словари словарь
четвёртый: четвёртая
большинство: большинстве
авторство: авторства
популярность: популярностью
восстание: восстание
правкипостоянный: правкипостоянная
дата: дата
материал: материал
множество: множество
псевдоним: псевдонимами псевдонимом
другой: другие других
февраль: февраля
саргина: саргина
отредактировать: отредактирована
ошибкекак: ошибкекак
языкаучёный: языкаучёные
алмазный: алмазные
писатель: писатели
обычно: обычно
второй: вторая второй
имя: имён
сказочный: сказочной
архивировать: архивировано
новый: нового новое
приём: приёмы
литература: литература литературы
министерство: министерства
наукимистификаторычлен: наукимистификаторычлены
стихотворение: стихотворения
переиздаваться: переиздавался
библиографический: библиографических
короткий: короткий
зодчество: зодчества
представиться: представились
июнь: июня
версия: версии версия
мария: мария
учиться: учился
белый: белого
учётный: учётную
пушкинист: пушкинист
воспоминание: воспоминания
делать: делающих
проза: проза
автор: автор авторы
варвар: варвара
значительно: значительно
десяток: десятка
финансы: финансов
подробный: подробнее
разработчик: разработчики
знак: знак
рис: рис
асеев: асеев асеева
алфавитупоэта: алфавитупоэты
владыка: владыка
отдельный: отдельных
векарусский: векарусские
место: место
гончаров: гончаровой
использование: использования
стих: стих стихами стихи
работать: работал
головинский: головинском
стиховедение: стиховедение стиховедения
подлинный: подлинный
поколение: поколения
немой: нем
эксперимент: экспериментов эксперименты
сложиться: сложился
точка: точки
обозрение: обозрение
стэнфордский: стэнфордского
стихосложение: стихосложении
требовать: требуют
плодотворно: плодотворно
астроном: астроном
драматургия: драматургии
часть: части
рембо: рембо
умереть: умер
россия: россии
катковский: катковском
одиозный: одиозной
третий: третья
викитекаэлемент: викитекаэлемент
сообщить: сообщить
перебой: перебоями перебоях
сергей: сергей сергея
прозаический: прозаических
корабль: корабля
языкпереводчик: языкпереводчики
участник: участниками
москвеумереть: москвеумершие
кодистория: кодистория
неизданный: неизданными
лексикон: лексикон
связаться: свяжитесь
код: код
включая: включая
изд: изд
страницецитировать: страницецитировать
произведение: произведений произведения
блок: блока
пер: пер
проверяться: проверялась
переводчик: переводчик
казак: казак
манера: манеры
статьяобсуждение: статьяобсуждение
культура: культура
один: одним
несоответствие: несоответствие
ещё: ещё
четыркина: четыркина
империипоэта: империипоэты
сссрлитературный: сссрлитературные
викидать: викиданных
мочь: могут
проверить: проверенной
русский: русская русский русского русской
двурог: двурог
изобразительный: изобразительного
имитация: имитациями
поэтический: поэтическим
подданство: подданство
сподвижник: сподвижники
рождение: рождения
творчество: творчество
москвевыпускник: москвевыпускники
кладбище: кладбище
зодчестваперсоналий: зодчестваперсоналии
математик: математик
алфавитупереводчик: алфавитупереводчики
память: памяти
жанр: жанр
день: день
векапоэт: векапоэты
черносотенец: черносотенцем
заглавный: заглавная
печататься: печатался
монино: монина
круг: кругах
больший: большая
описать: описал
поведение: поведения
характерный: характерны характерные
кук: куки
несколько: несколько
стиховедческий: стиховедческих
перевод: перевода переводов переводом
тон: тон
ритмика: ритмике
футуризм: футуризма
создание: создания
антология: антологии
биография: биография
маковца: маковец
издательство: издательство
рик: рик
девять: девятью
похоронный: похоронен
прозаик: прозаик прозаики
шахматист: шахматист
поверх: поверх
авангардастиховедыпоэта: авангардастиховедыпоэты
последний: последний
текст: текст
драматург: драматурги
империя: империя
оставаться: остаются
университет: университета
февраляумереть: февраляумершие
период: периода
полный: полного
заявление: заявление
векавыпускник: векавыпускники
мобильный: мобильная
английский: английской
править: править
формальный: формальной
смерть: смерти
сюдасвязанный: сюдасвязанные
опытный: опытными
ответственность: ответственности
миф: мифов
среди: среди
копия: копия
объединение: объединения
кодекс: кодекс
кладбищесослать: кладбищесосланные
треть: трети
живопись: живописи
пользоваться: пользовавшиеся пользуясь
тема: темы
гражданство: гражданство
категория: категории
инструмент: инструменты
лес: леса
мать: мать
теоретик: теоретик
системеобсуждениевкладсоздать: системеобсуждениевкладсоздать
форма: форме
штудия: штудиях
замуж: замуж
конец: конца
активно: активно
чекист: чекистом
школьник: школьников
кузнецов: кузнецова
выступление: выступлений выступления
лицензия: лицензии
человек: людях
начало: начале
пространство: пространства
гаспаров: гаспарова гаспаровым
действительность: действительности
сайт: сайте
ноябряродившийся: ноябряродившиеся
страницыслужебный: страницыслужебные
вновь: вновь
ссылка: ссылки
философия: философии
ссср: ссср
близкий: ближайшие
империипереводчик: империипереводчики
конфиденциальность: конфиденциальности
роланд: роланде
выступать: выступал
смотреть: см
годуродиться: годуродившиеся
популяризатор: популяризатор
подделка: подделки
редактор: редактор
французский: французского
м: м
китайский: китайская
богословский: богословская
октябрь: октября
товарный: товарный
бубер: бубера
крикнуть: крикнул
записка: записки
зарегистрировать: зарегистрированный
александр: александра
постсимволистский: постсимволистскую
исследование: исследования
спецификация: спецификация
идитол: идитола
она: неё
викитека: викитеке
критик: критик
фонодокумент: фонодокументах
россиипереводчик: россиипереводчики
дольник: дольник
статьислучайный: статьислучайная
чрезвычайно: чрезвычайно
математика: математике
иванович: ивановна
доступный: доступен
сокровище: сокровище
языкова: языкова
житейский: житейской
мертвец: мертвец
организация: организации
фигура: фигуру
пьяный: пьяного
известный: известного
анастасия: анастасия
скачать: скачать
старейшина: старейшины
пропуск: пропуски
случай: случаях
история: историй
иван: иван
оставить: оставил
пока: пока
большой: большой
проект: проектах
лернер: лернер
признать: признал
лицей: лицее
репрессированный: репрессированные
фамилия: фамилией
собрание: собрания
сохранение: сохранением
кокчетавскрыть: кокчетавскрытые
обращение: обращения
текущий: текущая
детский: детская
бобёр: бобров
описание: описание
паузник: паузник
участие: участие
правка: правки
ноябрь: ноября
архимедовый: архимедово
перевести: перевел
центральный: центральном
поэтесса: поэтесса
словораздел: словоразделов
организатор: организаторов
авангардахудожественный: авангардахудожественные
название: названием
сссрпереводчик: сссрпереводчики
барьер: барьеров
возглавлять: возглавлял
вольнослушатель: вольнослушателем
