мы: нами
гнездо: гнездо
приём: прием
близлежащий: близлежащих
праведник: праведник
другой: другими других
собянин: собянину
москвыакционерный: москвыакционерные
сельян: сельянов
гараж: гаража
использовать: использующие
продолжить: продолжено
движение: движение
протестовать: протестовали
нога: ноги
сентиментальный: сентиментальное
изучение: изучения
годуфильм: годуфильмы
официальный: официальный
пожар: пожар пожара
фигура: фигуры
автостоп: автостоп
энциклопедия: энциклопедии
каренин: каренина
возраст: возраст
кинокомпания: кинокомпании
мосфильм: мосфильм
сентябрь: сентября
том: томах томов
продолжение: продолжения
версияправитьправить: версияправитьправить
цао: цао
центр: центр
спб: спб
стб: стб
фильм: фильм фильма фильмами фильмы
директор: директор
правкиновое: правкиновые
чужой: чужой
основать: основав основанные
государственный: государственным
ресурс: ресурсы
расположение: расположение
подземный: подземного
перейти: перейти
широта: ш
душа: душа
кабельный: кабельных
гамбит: гамбит
подвиг: подвиг
примечание: примечания
оказаться: оказался
страницасодержаниеизбрать: страницасодержаниеизбранные
дом: дом дома доме домов
мэрия: мэрию
работа: работой
житель: жителей жители жителями
навигация: навигации навигация
лендок: лендок
страница: страница страницы
колокол: колокол
отличаться: отличаться
идея: идея
актриса: актриса актрису
персона: персона
википедия: википедии википедия
детектив: детектив
режиссёр: режиссёр
чонкин: чонкина
юрженко: юрженко
российский: российская российские российский российское
валерий: валерий
год: год года году лет
профит: профит
статьятекущий: статьятекущие
статьисообществофорумсправкасвежий: статьисообществофорумсправкасвежие
архив: архив архива
среда: среда
доля: доля
чемпион: чемпион
июль: июля
приключение: приключения
печать: печати
полицейский: полицейская
угол: угол
политика: политика
медведь: медведь
питер: питер
козихинский: козихинский козихинского козихинском
экипаж: экипаж
имя: имени имён
серия: серию
записьвойти: записьвойти
слить: слитых
иван: ивана
произойти: произошел
жёлтый: жёлтого
дополнительный: дополнительные
конец: конце
медиафайл: медиафайлы
тематический: тематические
коммерческий: коммерческое
сайт: сайт сайты
пикетировать: пикетировавшая
который: которого котором которых
объединение: объединение
съёмка: съёмки
советский: советские советским советское
солнце: солнцем
выбор: выбор
разведчик: разведчика
михалков: михалков михалкова михалковы михалковым
централ: централ
пол: полу
фонд: фонд
предварительный: предварительной
книга: книга книги
качество: качестве
любовь: любви
телеканал: телеканал телеканалом телеканалы
путешествие: путешествие
элита: элиты
поиск: поиск поиску
страницуполучить: страницуполучить
обвинить: обвинили
амедиа: амедиа
радовать: радуют
атв: атв
мама: мама
предстояние: предстояние
отец: отец
исторический: историческая исторические исторических
великий: великой
язык: язык языках
поддубный: поддубный
михалковкинокомпания: михалковкинокомпании
гигантский: гигантский
отечественный: отечественного
мелодрама: мелодрама
исследовательский: исследовательской
компания: компании
март: марта
популярный: популярных
каталог: каталогах
просмотр: просмотры
так: т
свой: своих
выгорать: выгорает
заявить: заявил
помощь: помощью
андреевский: андреевский
ссылкасведение: ссылкасведения
строительство: строительства строительстве строительство
действовать: действовать
орт: орт
лицо: лицах
внешний: внешние
отказ: отказ
событияпожертвовать: событияпожертвовать
ежегодник: ежегодник
нона: нон
россия: россии россия
пушкин: пушкина
кирпич: кирпича
отмечать: отмечает отмечал
призвать: призвали
символ: символ
вайта: вайт
неполучиться: неполучившегося
проверка: проверки
реквием: реквием
парадиз: парадиз
оценка: оценки
общество: общества общество
хороший: лучшие хороший
кинематографический: кинематографический
путин: путиным
время: времени время
указание: указанием
программа: программ
шпион: шпион шпиона
викисклад: викискладе
жанр: жанр жанрам
империя: империи
высотность: высотность
викимедиа: викимедиа
читатьтекущий: читатьтекущая
правка: правок
эксмо: эксмо
свободный: свободной
андрей: андрей
сельяновый: сельянова
воронцов: воронцова
горький: горького
волшебный: волшебные
некоммерческий: некоммерческой
поджог: поджога
кинофильм: кинофильмы
восемь: восемь
традиция: традиции
содержание: содержание
декабрь: декабря
термин: терминов
генерал: генерал
явиться: явился
тираж: тираж
персонаж: персонажей
персональный: персональные
урга: урга
указать: указан
всемирный: всемирные
продукция: продукция
условие: условий условия
москва: москва москве москвы
держать: держащий
также: также
мельница: мельница
бременский: бременские
ртр: ртр
два: двух
январь: января
следствие: следствием
первый: первый первых
владимир: владимира
кинопрокатчик: кинопрокатчика
николай: николая
протест: протестом
требование: требованию
документальный: документальные
авторство: авторства
местный: местными местных
буква: буквы
труд: труд
правкипостоянный: правкипостоянная
материал: материал
дата: дата
бурый: бурый
сидоров: сидоров
огонь: огонь
название: название
раззак: раззаков
уверить: уверены
февраль: февраля
отредактировать: отредактирована
тритэ: тритэ
ошибкекак: ошибкекак
прокат: прокат
киностудия: киностудия
победа: победы
издание: издание
колодец: колодцы
заказчик: заказчиком
место: месте
открытый: открытое
леонид: леонид
осуществлять: осуществляет
многотомный: многотомное
против: против
алексей: алексей
архивировать: архивировано
литература: литература
удар: удар
единомышленник: единомышленниками
август: август августа
слово: слов
библиографический: библиографических
короткий: короткий
представиться: представились
являться: является
проект: проект проекта проектах проекту
июнь: июня
сергей: сергей сергею сергея
версия: версии версия
глубокий: глубокой
учётный: учётную
волшебник: волшебник
это: это
тренер: тренер
этот: эта
воронеж: воронеж
замыкание: замыкание
значительно: значительно
анна: анна
подробный: подробнее
разработчик: разработчики
знак: знак
флаг: флаг
приурочить: приурочило
руб: руб
воссоздать: воссоздать
канал: канал каналах каналов
переулок: переулка переулке переулок
отдельный: отдельных
гпм: гпм
использование: использования
университет: университеты
телесериал: телесериалы
мастер: мастеров
архитектор: архитектора
редакторский: редакторская
климашевский: климашевская
сталин: сталин
кожугетыч: кожугетыч
фото: фото
деятельность: деятельность
цитадель: цитадель
викискладэлемент: викискладэлемент
акционерный: акционерное
вместе: вместе
требовать: требуют
уникальный: уникальное
магасфильм: магасфильм
однако: однако
серебряный: серебряные
базелевс: базелевс
снос: сноса
верещагин: верещагин
век: века
игнатьев: игнатьев
апрель: апреля
поднимать: поднимали
сахафильм: сахафильм
неопр: неопр
будущее: будущего
сообщить: сообщить
противник: противников
россиянин: россиян
совместно: совместно
кодистория: кодистория
связаться: свяжитесь
участник: участниками
солнечный: солнечный
код: код
страницецитировать: страницецитировать
тащить: тащили
стройка: стройки стройкой стройку
заяц: зайцев
проверяться: проверялась
чёрный: черных чёрные
премьерный: премьерному
малый: малом малый
статьяобсуждение: статьяобсуждение
культура: культура
аудио: аудио
москвич: москвичи
студия: студии студию студия
отрасль: отрасль
данные: данных
новый: новейшая нового
ещё: ещё
гореславский: гореславская
тнт: тнт
соседний: соседнем
мой: мою
публиковаться: публикуются
лапа: лапах
неплохой: неплохими
лента: ленту
викидать: викиданных
основатель: основатели
мочь: могут
проверить: проверенной
русский: русская русские русский русского русской
документ: документов
показ: показу
азазель: азазель
выход: выхода
мэтр: мэтр мэтра
электропроводка: электропроводке
творчество: творчество
активный: активных
алгоритм: алгоритм
сибирский: сибирский
ленфильм: ленфильм
мирошниченко: мирошниченко
день: день
заглавный: заглавная
группа: группа
правление: правления
поведение: поведения
кук: куки
бортко: бортко
умереть: умереть
восстать: восстать
сеанс: сеанс
остров: остров
борный: борна
избранный: избранное
ств: ств
пересмотреть: пересмотреть
строение: строений
музыка: музыка
уменьшить: уменьшить
художник: художники
мумия: мумию
никита: никита никитой
выпуск: выпуска
статистика: статистика
издательство: издательство
сбор: сборы
контекст: контекст
история: история
сссркинокомпания: сссркинокомпании
военный: военная
статский: статский
префект: префект префекту
необычайный: необычайные
интересный: интересных
кит: кит
предпринимательство: предпринимательства
орешек: орешек
последний: последний
башкортостан: башкортостан
текст: текст
заниматься: занимается
пара: пара
художественный: художественные
назвать: названо
расколоться: раскололся
прийти: пришедших
млн: млн
аббревиатура: аббревиатура
бартенёв: бартенёва
сост: сост
выступать: выступает
байдакова: байдакову
заявление: заявление
мобильный: мобильная
утомлённый: утомлённые
править: править
захват: захвате
ряд: ряда
родина: родину
сюдасвязанный: сюдасвязанные
опытный: опытными
здание: зданий
зритель: зрителей
миссия: миссия
далее: д
невафильм: невафильм
ответственность: ответственности
работать: работающие
гостиница: гостиницы
среди: среди
региональный: региональных
кодекс: кодекс
живопись: живописи
наш: наш
омут: омуты
кинорежиссёр: кинорежиссёром
наиболее: наиболее
категория: категории
май: мая
почему: почему
инструмент: инструменты
изумрудный: изумрудного
выпускать: выпускать
карточка: карточка
партнершип: партнершип
снимать: снимают
бурляева: бурляева
догилев: догилева
кончаловский: кончаловские
системеобсуждениевкладсоздать: системеобсуждениевкладсоздать
тип: тип
пятый: пятый
артос: артос
карта: картами
рок: рок
стать: стал
востребовать: востребован
активно: активно
святой: святой
лицензия: лицензии
пространство: пространства
наследовать: наследует
тв: тв
нежный: нежный
человек: люди
поляк: поляков
страницыслужебный: страницыслужебные
создать: созданное
ссылка: ссылки
дирекция: дирекция
грат: грата
жилец: жильцы
нтв: нтв
остановка: остановка
кинематограф: кинематограф
предприимчивый: предприимчивый
конфиденциальность: конфиденциальности
учёт: учёта
адаптация: адаптация
снести: снесенных
ключевой: ключевые
дикси: дикси
смотреть: см
видео: видео
дорога: дорога
музыкант: музыканты
тихий: тихие
россиискрыть: россиискрытые
реформа: реформ
солдат: солдата
алфавитукомпания: алфавитукомпании
старый: старые
просить: просят
россиипреснякинокомпания: россиипреснякинокомпании
медиа: медиа
академия: академия
милиционер: милиционеры
октябрь: октября
город: города
сохо: сохо
товарный: товарный
генеральный: генеральный
конёк: коньки
зарегистрировать: зарегистрированный
турецкий: турецкий
кино: кино
александр: александра
паровоз: паровоз
премьера: премьеры
префектура: префектуры
снг: снг
начать: начал
фортунат: фортунатов
метр: метра
заблокировать: заблокировал
территория: территория
вверх: вверх
обочина: обочине
статьислучайный: статьислучайная
отказать: отказать
три: трёх
советник: советник
жизнь: жизнь
психологический: психологическая
часть: часть
доступный: доступен
наука: наука
организация: организации
товарищество: товарищество
драма: драма
ценный: ценных
татьяна: татьяна
превосходство: превосходство
председатель: председатель
церковь: церкви
бюллетень: бюллетень
скачать: скачать
аркус: аркус
археографический: археографический
случай: случаях
пророк: пророк
крепкий: крепкий
пока: пока
вест: вест
государственник: государственника
основание: основание
оформить: оформленную
свердловский: свердловская
европа: европа
сохранение: сохранением
приостановить: приостановят
обращение: обращения
воедино: воедино
текущий: текущая
росспэн: росспэн
описание: описание
участие: участие
ноябрь: ноября
око: очи
цирюльник: цирюльник
мир: мира
стрелец: стрельцов
гибель: гибель
обратиться: обратились
проблема: проблемы
словарь: словаря
великолепно: великолепно
фасад: фасады
издательский: издательский
источник: источник
легенда: легенда
