войско: войск войсках
войти: войти
кавказ: кавказ
война: война войну войны
действовать: действовать
подробный: подробнее
способный: способного
начало: начале
статья: статьи статья
год: гг год года году
ошибка: ошибке
описание: описание
человек: людях человек человеком
выпустить: выпущен
авторство: авторства
материал: материал
сторона: стороны
сентябрь: сентября
иван: ивана
смерть: смерти
зарекомендовать: зарекомендовал
московский: московского московской московском
получить: получил получить
лошадь: лошади
октябрь: октября
олицетворять: олицетворял
заглавный: заглавная
содержание: содержание
премия: премии
который: которого которой
поиск: поиск поиску
варвара: варварой
генерал: генерала
обсуждение: обсуждение
кук: куки
свежий: свежие
река: реке
скончаться: скончался
смотреть: см
код: код
инструмент: инструменты
корпус: корпуса корпусе
справка: справка
богданов: богдановой
вскоре: вскоре
новый: новые
страница: страница странице страницу страницы
ноябрь: ноябре
кадетский: кадетского кадетском
бригада: бригаду
производство: производства
николаевский: николаевской
участие: участие
прапорщик: прапорщиком
штаб: штаб штаба
элемент: элемент
российский: российская
орден: орден ордена орденом
кавказский: кавказская кавказской
условие: условий условия
золотой: золотого золотое золотой
отряд: отряда отряде
читать: читать
запись: запись
тип: тип
форум: форум
список: списки
википедия: википедии википедия
представиться: представились
хороший: лучшей
этот: эта
выпускник: выпускники выпускников
полторацкий: полторацкого
мы: нами
гергебиль: гергебилем
состоять: состоя состоял
белый: белой
текущий: текущие
наградить: награждён
падение: падении падения
удостоить: удостоен
командировать: командирован
создать: создать
правка: правки
бант: бантом
оружие: оружие оружия
имя: имён
перевести: переведён
происходить: происходил
подполковник: подполковник подполковники
ушиб: ушиба
текст: текст
съёмка: съёмке
кодекс: кодекс
баяндурский: баяндурского
время: время
шпага: шпаги
история: история
восточный: восточной
участник: участник участники
постоянный: постоянная
печать: печати
артиллерийский: артиллерийскую
кавалер: кавалеров кавалеры
мобильный: мобильная
викидать: викиданных
непродолжительный: непродолжительна
алфавит: алфавиту
офицер: офицер офицера
генеральный: генерального генеральный
дмитрий: дмитрий
сам: самой самом
храбрый: храброго
энциклопедия: энциклопедии
спб: спб
исмаил: исмаилов
св: св
умерший: умершие
пространство: пространства
крымский: крымская крымскую
русский: русский русского
пожертвовать: пожертвовать
деятельность: деятельности
доступный: доступен
скрытый: скрытая
накануне: накануне
наружность: наружностью
погибший: погибшие
ст: ст
родиться: род родившиеся
занятие: занятий
звание: звание
пребывание: пребывания
источник: источник источники
язык: языках
знак: знак
учётный: учётную
событие: события
некоммерческий: некоммерческой
категория: категории категория
военный: военную
отличие: отличие
короткий: короткий
верховье: верховьях
сообщество: сообщество
случай: случаях
ольшевский: ольшевский
сюда: сюда
академия: академии академию
разряд: разряду
милый: милым
скачать: скачать
викимедиа: викимедиа
свечин: свечин свечина свечины
раненый: раненый
кубань: кубани
брак: брака
губерния: губернии губерниях
головной: головного
сражение: сражении сражения
монгольский: монгольский
первый: первого
вклад: вклад
использование: использования
товарный: товарный
награда: награды
персональный: персональные
случайный: случайная
отредактировать: отредактирована
система: системе
иванович: иванович
россия: россия
тифлис: тифлисе
ссылка: ссылка ссылки
персоналия: персоналии
местность: местности
самурский: самурского
боевой: боевое
владимир: владимира
сведение: сведения
служебный: служебные
фамилия: фамилией
служба: служба
другой: других
сообщить: сообщить
храбрость: храбрость
версия: версия
избранный: избранные
статистика: статистика
отдельный: отдельных
принадлежность: принадлежность
дворянин: дворян
обычный: обычного
лицензия: лицензии
выпуск: выпуске
отказ: отказ
рекогносцировка: рекогносцировки
проект: проектах
империя: империя
перейти: перейти
сохранение: сохранением
свободный: свободной
заявление: заявление
высокий: высокой
центральный: центральных
указание: указанием
сын: сын
пехотный: пехотной
конфиденциальность: конфиденциальности
ответственность: ответственности
квартирмейстер: квартирмейстером
связанный: связанные
китаец: китайца
навигация: навигации навигация
дата: дата
ещё: ещё
связаться: свяжитесь
петрович: петровича
поведение: поведения
надпись: надписью
результат: результате
разработчик: разработчики
александрович: александровной
степень: степени
дивизия: дивизии
добавить: добавить
дополнительный: дополнительные
образование: образование
капитан: капитаны
турчидаг: турчидагом
изображение: изображений
последний: последний
слово: словам
бебутовый: бебутова
цитировать: цитировать
организация: организации
произвести: произведён
характеризовать: характеризовал
горец: горцами
январь: января
март: марта
зарегистрировать: зарегистрированный
глиноецкий: глиноецкий
фонд: фонд
политика: политика
святой: святого
прозвище: прозвище
исторический: исторический
подпоручик: подпоручики
просмотр: просмотры
очерк: очерк
мочь: могут
поступить: поступил
ус: усами
рождение: рождения
править: править
