войти: войти
составлять: составляет составляли
волость: волости волость
прошлый: прошлом
количество: количество
описание: описание
авторство: авторства
федеральный: федеральная федеральный
материал: материал
поиск: поиск поиску
инструмент: инструменты
страница: страница странице страницу страницы
опочка: опочка опочки
район: район района районе районов
обращение: обращения
тип: тип
представиться: представились
область: области область
статистика: статистика статистики
текст: текст
кодекс: кодекс
километр: километров
умеренно: умеренно
псковский: псковская псковской
апрель: апреля
безморозный: безморозного
россия: россии россия
воротовый: воротово
событие: события
природный: природных
пункт: пунктах пункте пунктов пункту пункты
случай: случаях
карта: картами карты
максимум: максимум
схема: схема
структура: структуре
результат: результатам
статья: статьи статья
всероссийский: всероссийской
скрытый: скрытые
населень: населени
население: население населения
лес: лесов
служебный: служебные
октмый: октмо
условие: условий условия
версия: версия
перечень: перечня
индекс: индекс
среднегодовой: среднегодовое
расстояние: расстоянии
г: г
приказ: приказ
который: которых
перейти: перейти
идентификатор: идентификаторы
англ: англ
продолжительность: продолжительность
связаться: свяжитесь
незавершённый: незавершённые
деление: деление
административный: административного
архивировать: архивировано
сельский: сельского сельское сельскому
март: марта
фонд: фонд
администрация: администрации
холодное: холодного
мочь: могут
навигация: навигации навигация
состав: состав
период: период периода
относительно: относительно
октябрь: октябрь октября
заглавный: заглавная
заготовка: заготовка
содержание: содержание
м: м
опочецкий: опочецкий опочецкого опочецком
код: код
таблица: таблица
московский: московское
лесорастительный: лесорастительных
поселение: поселение поселения
её: её
широта: ш
значение: значения
день: дней
этот: эта
часть: части
населить: населённом населённому населённых
перепись: переписи
правка: правка правки
источник: источник источниками
ресурс: ресурсов
алфавит: алфавиту
год: гг года году
численность: численности численность
среднее: среднем
глубоковский: глубоковская глубоковской
федерация: федерации
русский: русские русский
пожертвовать: пожертвовать
окончательный: окончательным
язык: языках
некоммерческий: некоммерческой
сообщество: сообщество
заявление: заявление
ответственность: ответственности
утверждение: утверждении
многолетний: многолетняя
персональный: персональные
зона: зон зоне
отредактировать: отредактирована
минимум: минимум
география: география
система: системе
применять: применяемого
ссылка: ссылка ссылки
населённый: населённые
нп: нп
сообщить: сообщить
субъект: субъект
пояс: пояс
избранный: избранные
википедия: википедии википедия
климат: климат
каждый: каждому
лицензия: лицензии
смещение: смещение
ещё: ещё
примерно: примерно
цифровой: цифровые
мм: мм
неопр: неопр
восток: востоку
править: править
действовать: действовать
подробный: подробнее
ошибка: ошибке
часовой: часовой
ата: ате
исчисление: исчислении
месяц: месяца
статус: статус
база: база
море: моря
обсуждение: обсуждение
кук: куки
муниципальный: муниципальный муниципальных
последний: последний последняя
государственный: государственной
участие: участие
запись: запись
характеризоваться: характеризуется
форум: форум
министерство: министерства
согласно: согласно
создать: создать
нохчийна: нохчийн
имя: имён
печать: печати
постоянный: постоянная постоянного
страна: страна
викидать: викиданных
закон: закон
образование: образований
пространство: пространства
национальность: национальность
знак: знак
получить: получить
товарный: товарный
сюда: сюда
скачать: скачать
вклад: вклад
сайт: сайт
сведение: сведения
служба: служба
другой: другие других
каменный: каменного
преобладать: преобладающая
июнь: июня
русый: рус
июль: июля
абсолютный: абсолютная абсолютный
влажный: влажный
цитировать: цитировать
континентальный: континентальный
весь: вся
зарегистрировать: зарегистрированный
политика: политика
окато: окато
данные: данных
просмотр: просмотры
помочь: помогите
центр: центра
итог: итогам
город: города
свежий: свежие
смотреть: см
справка: справка
планирование: планирования
новый: новые
москва: москва
прямой: прямой
деревня: деревня
элемент: элемент
время: времени время
читать: читать
мы: нами
текущий: текущие
сам: самого
топоним: топонима
история: история
лесной: лесных
мобильный: мобильная
энциклопедия: энциклопедии
доступный: доступен
почтовый: почтовый
человек: человека
учётный: учётную
температура: температура
территориальный: территориального
короткий: короткий
дополнить: дополнив
викимедиа: викимедиа
использование: использования
случайный: случайная
находиться: находится
национальный: национальной
категория: категории
мск: мск
псков: псков
отдельный: отдельных
высота: высота
отказ: отказ
проект: проектах
сохранение: сохранением
свободный: свободной
указание: указанием
конфиденциальность: конфиденциальности
официальный: официальный
метр: метров
связанный: связанные
дата: дата
поведение: поведения
тёплый: тёплого
разработчик: разработчики
дополнительный: дополнительные
входить: входит
изображение: изображений
это: это
коряк: коряков
дать: данные
примечание: примечания
организация: организации
август: августа
уровень: уровнем
российский: российской
озеро: озера
январь: января
средний: средняя
осадки: осадков
выпадать: выпадает
