войти: войти
олимп: олимп олимпа
жить: жил жить
метасерия: метасерии метасерия
новелла: новеллы
логан: логан
количество: количество
дума: дум дума
предположительно: предположительно
авторство: авторства
описание: описание
война: война войну
материал: материал
новый: новая новые
такой: такие таким таких такого
кошка: кошка
наиболее: наиболее
пища: пищи
поиск: поиск поиску
один: одним одно одного
отрезать: отрезанными
обложка: обложка
всё: всё
заметить: замечено
уокер: уокером
асгарда: асгард асгарда
инструмент: инструменты
инфицировать: инфицирован инфицированного инфицированные инфицированный
подходящий: подходящего
страница: страница странице страницу страницы
мочь: могла могли могут
магия: магии магию магия
несмотря: несмотря
альтрон: альтрон
комикс: комиксов комиксы
значительно: значительно
обращение: обращения
также: также
инфекция: инфекции инфекцию инфекция
уничтожать: уничтожать
передать: передал
заразить: заражены заражённого заражённых заразить
представиться: представились
целебный: целебным
особо: особо
ноябрь: ноября
измерение: измерении измерения
вуд: вуду
автор: автором авторы
текст: текст
кодекс: кодекс
взять: взять
начало: начало
вирус: вирус вируса вирусом вирусу
функциональный: функциональную
вина: вину
изолировать: изолированные изолированными изолировать
рид: рид
вселенная: вселенная вселенной вселенные вселенных
указать: указан
высокомощный: высокомощной
уата: уату
доктор: доктор доктора
живой: живых
отменить: отменить
космический: космического космической
апрель: апреля
том: тома
легко: легко
глаз: глаз глазом
северный: северной
навык: навыки
феникс: феникс феникса
колдун: колдуна
распространиться: распространиться
куба: куба
скрытый: скрытая
функционировать: функционировать
некротический: некротической
превращать: превращает
существо: существа существам существо
кевой: кевом
заражение: заражение заражению заражения
квм: квм
событие: события
медитация: медитацию
неорганический: неорганическим
связь: связи связь
джокаста: джокаста
влиять: влияет
продолжение: продолжение продолжениях
чёрный: чёрного чёрной
частичный: частичным
опубликовать: опубликованная
земля: земле земли
случай: случае случаях
создаваться: создаются
исцеление: исцеления
призрачный: призрачная
благодаря: благодаря
джек: джека
адский: адский
мордобой: мордобой
отличаться: отличаться
четвёрка: четверку
гелиополис: гелиополис
сорвиголова: сорвиголова
распространить: распространил распространить
пусть: пусть
друид: друида
удержать: удержать
иммунитет: иммунитет
утолить: утолить
цикл: цикл
тот: та те той
статья: статьи статья
трудно: трудно
неизвестно: неизвестно
смочь: смог
служебный: служебные
ксавьер: ксавьер
версия: версией версии версий версия версиями
личность: личности личность
условие: условий условия
суперзлодей: суперзлодеев
устойчивый: устойчивые
лекарство: лекарство
статистика: статистика
днк: днк
мистический: мистических мистическую
играть: играть
частый: частой
начаться: началась
говорить: говорит
нравственный: нравственные
перейти: перейти
заболевание: заболевание заболеваний
использоваться: используется
филлипс: филлипс
выиграть: выиграли
вид: вид
избавиться: избавиться
одолеть: одолеть
четыре: четырёх
мотив: мотивам
жанр: жанре
шторм: шторм
судьба: судьбы
связаться: свяжитесь
снова: снова
сдерживать: сдерживать
некоторый: некоторого некоторые некоторых
мёртвый: мёртв мёртвого
облик: облика
скрулла: скруллами
течение: течение
учёный: учёные
архивировать: архивировано
полковник: полковник
змея: змей
британия: британии британия
звёздный: звёздный
форма: формы
менее: менее
март: марта
фонд: фонд
голова: головам головами
пример: примером
ночной: ночной
арка: арок
установленный: установленного
мультсериал: мультсериал
миллар: миллар миллара
навигация: навигации навигация
железный: железный
радиация: радиацией
создать: создав создала создали созданным создать
смерть: смерть
поедание: поеданием
заключаться: заключается
апокалипсис: апокалипсис
демонический: демонический
ежемесячно: ежемесячно
отсутствие: отсутствие
ограниченный: ограниченная ограниченных
дормамма: дормамму
проходить: проходит
команда: команда команды
катастрофический: катастрофических
октябрь: октября
написать: написать
поместить: поместили
заглавный: заглавная
вредить: вредит
содержание: содержание
февраль: февраля
носитель: носителей
мир: миров миру
образец: образцы
общий: общей
код: код
вено: веном
пьерфедеричать: пьерфедеричи
продолжать: продолжать
умный: умными
сила: сила силы
её: её
протагонист: протагонисты
марраффиный: марраффино
свой: своей свои своим своих свой
страдать: страдают
состоять: состояла
авалон: авалон
этот: эта этих
графический: графические
похоже: похоже
гражданский: гражданская
роберт: роберт роберта
часть: части
исчезать: исчезает
список: список
правка: правки
связаный: связаные
древний: древних
водолей: водолей
плоть: плоти плоть плотью
интересный: интересное
сын: сын сына
грей: грей
год: года году лет
алфавит: алфавиту
рациональный: рациональными
герой: героев
мультивселенная: мультивселенная мультивселенной
отличный: отличные
художник: художник художника художниками художником
зомбировать: зомбированную зомбированные зомбированный
болезнь: болезнь болезнью
удаваться: удаётся
русский: русский
пожертвовать: пожертвовать
верховный: верховного
существование: существование
грег: грег грега
пим: пим
оса: осой
отдельный: отдельные отдельных
лейман: лейман
стремиться: стремятся
дэвид: дэвиду
тор: тор
профессор: профессор
язык: язык языках
некоммерческий: некоммерческой
рассесть: рассела
который: которая которого которой которую которые который
когтить: когтя
зажигать: зажигают
оба: оба
заменить: заменены
рисовать: рисовать
периодичность: периодичность
серия: серии серию серия сериях
напрямую: напрямую
сообщество: сообщество
заявление: заявление
кинематографический: кинематографическая
выживаемость: выживаемости
май: мая
ответственность: ответственности
персональный: персональные
интимный: интимной
отредактировать: отредактирована
голодный: голодны
постоянно: постоянно
система: системе системы
неизвестный: неизвестен неизвестна
огонь: огонь
лэнд: лэнд лэнда
проверка: проверки
любой: любая любое любой
ссылка: ссылка ссылки
несколько: нескольких
нацистский: нацистские
больший: большей большую
тереа: тереа
человек: человек
сохранить: сохранив
избежать: избежал избежать
фальтин: фальтином
мирко: мирко
шон: шон шона
разлагаться: разлагается
усиленный: усиленный
леший: леший
тёмный: тёмная
субъект: субъект
произведение: произведений
игра: игры
способность: способности способностям
википедия: википедии википедия
избранный: избранные
другой: другие другим других
невосприимчивый: невосприимчивы невосприимчивые
проверить: проверенной
ртуть: ртуть
сознание: сознание
лицензия: лицензии
следовать: следует
запустить: запущена
становиться: становятся
видимый: видимом
показать: показанной показано показаны
ещё: ещё
первый: первый первых
мэри: мэри
конечный: конечном конечный
разный: разных
мозг: мозг мозга
обязанность: обязанности
халк: халк
конечность: конечностей
весь: всему
свет: свет
сообщить: сообщить
антагонист: антагонисты
кто: кого
позволять: позволяет
самоконтроль: самоконтроль
присоединиться: присоединился
вместе: вместе
возможно: возможно
трансформера: трансформеры
америка: америка америке
неопр: неопр
изменение: изменений
править: править
выражать: выражает
дэдпул: дэдпул
вызывать: вызывает
действовать: действовать
подробный: подробнее
ошибка: ошибке
каратель: каратель
человеческий: человеческим человеческого
фильм: фильмы
оригинальный: оригинальной
бессмертие: бессмертием
энергия: энергиями
изначально: изначально
член: члены
атлантический: атлантическая
филлипёс: филлипса
идентичный: идентичной
обсуждение: обсуждение
кук: куки
персонаж: персонаж персонажей
сюжетный: сюжетных
гамбит: гамбит
парадоксальный: парадоксальный
сохранять: сохраняет
страх: страхе
джон: джон
орудие: орудие
участие: участие
зомби: зомби
страж: страж
тело: тела тело
механический: механическим
фред: фредом
запись: запись
форум: форум
начинать: начиная
хозяин: хозяина
орган: органов
остаться: остался
кокон: коконе
хэнк: хэнк
соколиный: соколиный соколиным
способный: способен способна способны
имя: имён
иметь: имеет имеют
печать: печати
поскольку: поскольку
постоянный: постоянная
единственный: единственный
фантастический: фантастическую
содержаться: содержался
кулак: кулак
пользователь: пользователей
интенсивный: интенсивную
выпуск: выпуски выпусков
викидать: викиданных
мнение: мнение
функция: функций
голосовой: голосовых
ван: ван
долгий: дольше
зелёный: зелёный
фрэнк: фрэнк фрэнка
пространство: пространства
выйти: вышла
пищеварительный: пищеварительной
действие: действие
хотя: хотя
запас: запасов
замаскироваться: замаскировавшимися
кроме: кроме
появляться: появляются
золотой: золотое
знак: знак
укус: укус
оборотень: оборотнем оборотня
получить: получить
искать: искал
испытывать: испытывают
интеллект: интеллект
моджо: моджо
альтернативный: альтернативные альтернативными
иностранный: иностранных
сюда: сюда
скачать: скачать
способствовать: способствовать
товарный: товарный
неделя: недель
момент: момент
оригинал: оригинала
вылечить: вылечить
большинство: большинству
сайт: сайт
вклад: вклад
требовать: требуют
сильный: сильный
отметить: отметил отметить
опытный: опытными
приквел: приквел
кроссовер: кроссовера
фантастика: фантастик
чувствовать: чувствуют
бог: богов
принимать: принимают
преодолеть: преодолеть
сведение: сведения
кейл: кейл
сталкиваться: сталкиваются
служба: служба
супермен: супермен супермена
восстановить: восстановит
контроль: контроль
гарт: гарт
мчаться: мчался
бланко: бланко
выступить: выступил
проглатывание: проглатывание
июнь: июня
росомаха: росомаха
мефисто: мефисто
увидеть: увидеть
два: двух
являться: является
ранее: ранее
лимб: лимб
секретный: секретная
приключение: приключения
происхождение: происхождении
капитан: капитан капитана
тяга: тяга
киркман: киркман
публикация: публикации
мера: мере
цитировать: цитировать
ричардс: ричардс
супергерой: супергероев
укусить: укусили
труп: трупам
зарегистрировать: зарегистрированный
политика: политика
питер: питеру
мистер: мистер
организм: организма
просмотр: просмотры
невероятно: невероятно
затем: затем
спать: спящую
танос: таносом
голод: голод
старик: старик
вспышка: вспышки
уровень: уровней
использовать: используя
выжить: выжить
медиа: медиа
сентябрь: сентябрь сентября
участник: участниками
временно: временно
марк: марк марка
амор: амора
ускоренный: ускоренного
повредить: повреждён
нижний: нижней
свежий: свежие
смотреть: см
вакцина: вакцину
джейн: джейн
джина: джин
роль: роль
справка: справка
проверяться: проверялась
серебряный: серебряный
работа: работы
итог: итоге
сочетание: сочетании
элемент: элемент
лента: ленте
например: например
самурай: самурай
невес: невес
дополнительный: дополнительное дополнительные
дважды: дважды
фабиано: фабиано
время: времени время
читать: читать
мы: нами
текущий: текущая текущие
затронуть: затронуты
пантеон: пантеонов
сам: самого
зверь: зверь
история: история
побеждать: побеждает
геркулес: геркулес
чума: чуму
отвечать: отвечает
киновселенная: киновселенные
мобильный: мобильная
стрэндж: стрэндж
колосс: колосс
ствол: стволе
изобразить: изображены
объединить: объединив
морбиуса: морбиусу
комедия: комедии
энциклопедия: энциклопедии
саймон: саймон
здоровье: здоровьем
нуждаться: нуждаются
красный: красный
доступный: доступен
источник: источник
обычно: обычно
учётный: учётную
категория: категории категория
общество: обществе
наблюдатель: наблюдатели
пипец: пипец
заклинание: заклинаниями
остановить: остановить
короткий: короткий
достигнуть: достигли
просто: просто
отрубленый: отрубленым
викимедиа: викимедиа
дженнифер: дженнифер
среди: среди
распространение: распространения
использование: использования
внепространственный: внепространственной
случайный: случайная
прививать: прививают
пока: пока
артур: артур
магнето: магнето
очень: очень
стрэнджа: стрэнджа
наблюдать: наблюдаемых
лёгкий: лёгких
три: трёх
последствие: последствия
пантера: пантеры
роуга: роуг
создатель: создатели
связка: связок
основной: основной основные
боль: боль
предел: пределах
узнать: узнал
гоблин: гоблин
фернандо: фернандо
реальность: реальностей
речь: речь
анимационный: анимационная
фактор: факторов
помощь: помощью
параллельный: параллельные
изгнанник: изгнанники
уотсон: уотсон
отказ: отказ
происходить: происходит
проект: проектах
различный: различных
издатель: издатель
гуманный: гуманные
энергетический: энергетическом
свободный: свободной
сохранение: сохранением
высокий: высокой
крайний: крайней
указание: указанием
конфиденциальность: конфиденциальности
кольцо: кольцо
инфекционный: инфекционное
гея: геей
очевидный: очевидно
связанный: связанные
дата: дата
аниме: аниме
уникальный: уникальные
часто: часто
хотеть: хотят
поведение: поведения
превращение: превращения
корпус: корпус
представить: представлены
разработчик: разработчики
вариация: вариации
зависимость: зависимости
жертва: жертву
опасный: опасен
суйти: суйдем
физиология: физиологии
это: это
последний: последний
доставаться: достаётся
примечание: примечания
организация: организации
замечание: замечание
однако: однако
доказать: доказал
образ: образом
январь: января
проблема: проблем
киркмана: киркмана
некрономикон: некрономикона
циклоп: циклоп
убивашка: убивашка
