смоленский: смоленская смоленский смоленским смоленского смоленское смоленской
голова: голова головой головы
головыпочётный: головыпочётные
отказ: отказ
мы: нами
магазин: магазин
училище: училища училище
событияпожертвовать: событияпожертвовать
системеобсуждениевкладсоздать: системеобсуждениевкладсоздать
лещенок: лещенка
тип: тип
областивыпускник: областивыпускники
сообщить: сообщить
год: года годах году лет
банк: банк
улица: улиц
время: время
изображение: изображений
общество: общества
губернский: губернским губернского губернское
входить: входил
кодистория: кодистория
правоведениясмоленский: правоведениясмоленские
человек: людях человек
лицензия: лицензии
использовать: использующие
указание: указанием
семья: семье
лопатин: лопатина
пространство: пространства
связаться: свяжитесь
код: код
продолжать: продолжал
оригинал: оригинала
лечение: лечение
страницецитировать: страницецитировать
императорский: императорского императорское
князь: князю
губерния: губернии губерния
судебный: судебного
викимедиа: викимедиа
обучаться: обучаться
страница: страница страницы
гимназия: гимназий
свободный: свободной
страницыслужебный: страницыслужебные
уездный: уездным
статья: статьи
ссылка: ссылки
предводитель: предводителем
энциклопедия: энциклопедии
российский: российская
потёмкин: потёмкин потёмкина потёмкину
читатьправитьправить: читатьправитьправить
некоммерческий: некоммерческой
гражданин: граждане гражданин гражданином
статьяобсуждение: статьяобсуждение
дворянский: дворянской
родственник: родственником
сентябрь: сентября
одновременно: одновременно
ещё: ещё
декабрь: декабря
страна: страна
покровительствовать: покровительствовал
сентябряумереть: сентябряумершие
конфиденциальность: конфиденциальности
активный: активной
правкиновое: правкиновые
секретарь: секретаря
алфавитуродившийся: алфавитуродившиеся
член: членом
очередь: очередь
смотреть: см
годуродиться: годуродившиеся
викидать: викиданных
персональный: персональные
деятельность: деятельности
департамент: департаменте
что: чём
управа: управой
хозяйство: хозяйства хозяйством
перейти: перейти
мочь: могут
русский: русский
болеть: болел
условие: условий условия
примечание: примечания
страницасодержаниеизбрать: страницасодержаниеизбранные
создать: создан
вынудить: вынужден
дворянство: дворянства
также: также
состоять: состоял
городской: городские городским городского городской
рождение: рождения
ездить: ездить
навигация: навигации навигация
январь: января
государственный: государственной
первый: первый
элемент: элемент
товарный: товарный
расширение: расширение
площадь: площадей
авторство: авторства
зарегистрировать: зарегистрированный
губернатор: губернатора
смоленск: смоленск смоленска смоленском
постоянно: постоянно
википедия: википедии википедия
книжный: книжный
александр: александра
пользоваться: пользовался
заглавный: заглавная
дата: дата
материал: материал
родиться: род родившиеся родился
сельский: сельским сельского
скончаться: скончался
статьятекущий: статьятекущие
статьисообществофорумсправкасвежий: статьисообществофорумсправкасвежие
поведение: поведения
кук: куки
поздний: позднее
отредактировать: отредактирована
приходиться: приходился
ошибкекак: ошибкекак
руководство: руководства
печать: печати
добавить: добавить
николаевич: николаевич
григориевич: григорьевича
политика: политика
биография: биография
избрать: избран
статьислучайный: статьислучайная
статистика: статистика
григорий: григорию
уезд: уезд уезда
ряд: ряд
имя: имён
записьвойти: записьвойти
дмитрий: дмитрий
вернуться: вернувшись вернулся
помощник: помощником
доступный: доступен
дополнительный: дополнительные
канцелярия: канцелярии
меценатство: меценатству
архивировать: архивировано
правоведение: правоведению правоведения
организация: организации
поддержка: поддержкой
получить: получив
правительствовать: правительствующего
февраль: феврале
короткий: короткий
скачать: скачать
часто: часто
представиться: представились
последний: последний
случай: случаях
правкипостоянный: правкипостоянная
почётный: почётный почётным
текст: текст
вопрос: вопросу
империя: империя
окончить: окончил
уездеумерший: уездеумершие
фонд: фонд
учётный: учётную
проект: проектах
открыть: открыты
этот: эта
фамилия: фамилией
чин: чин
заявление: заявление
поиск: поиск поиску
столоначальник: столоначальником
служить: служил
благоустроить: благоустроены
страницуполучить: страницуполучить
пост: поста
деревня: деревне деревня
школа: школ
сохранение: сохранением
шесть: шесть
мобильный: мобильная
обращение: обращения
править: править
язык: языках
подробный: подробнее
разработчик: разработчики
дальний: дальним
знак: знак
смерть: смерти
описание: описание
сюдасвязанный: сюдасвязанные
отдельный: отдельных
сенат: сената
заниматься: занимался
ноябрь: ноября
участие: участие
место: место
уйти: ушёл
другой: других
подъём: подъёма
использование: использования
ответственность: ответственности
отделение: отделения
март: марта
присутствие: присутствие
просмотр: просмотры
крестьянский: крестьянскому
кодекс: кодекс
годуперсоналия: годуперсоналии
версия: версия
категория: категории
ссылкасведение: ссылкасведения
источник: источник
мартародиться: мартародившиеся
инструмент: инструменты
служба: службы
смоленскаскрыть: смоленскаскрытые
действовать: действовать
