ввс: ввс
тема: теме
войти: войти
проблема: проблема
викицитатник: викицитатник викицитатнике
описание: описание
авторство: авторства
материал: материал
детектив: детектив
женщина: женщины
принц: принца
поиск: поиск поиску
билет: билет
герой: герой героя
всё: всё
ссылка: ссылка ссылками ссылки
инструмент: инструменты
ступать: ступала
обращаться: обращается
алтарь: алтарь
страница: страница странице страницу страницы
значительно: значительно
колесо: колесо колёсами
жизнь: жизнь жизнью
бесконечный: бесконечный
охота: охота
утилизатор: утилизатор
жена: жена
представиться: представились
журнал: журнале
плотный: плотная
джоэниса: джоэниса
убийство: убийство
текст: текст
кодекс: кодекс
авторский: авторском
сюжет: сюжет
мантра: мантрой
клондайка: клондайка
коль: коль
безымянный: безымянная
тепло: тепло
совпадение: совпадения
написать: написан
доктор: доктор доктора доктору
фантастический: фантастические
офицер: офицера
скопление: скоплением
человек: людей людьми человека
арктур: арктура
заяц: заяц
событие: события
чей: чей
связь: связи
замаскированный: замаскированный
случай: случаях
клиент: клиента
корабль: корабле
задаром: задаром
ордер: ордер
отличаться: отличаться
сцилла: сциллой
вещь: вещь
академия: академия
статья: статьи статья
планета: планета планете планету
скрытый: скрытые
болотный: болотного
служебный: служебные
элистер: элистера
мятеж: мятеж
версия: версии версия
условие: условий условия
который: которое которую
перейти: перейти
мозг: мозгов
связаться: свяжитесь
хождение: хождение
пищевод: пищевод
призрак: призрак
больший: большим
добавить: добавить
паломничество: паломничество
ты: тебе
ключ: ключ
название: названием названия
папазиан: папазиан папазианом
фонд: фонд
цена: цена
мочь: могут
навигация: навигации навигация
беличий: беличье
риск: риск риска
октябрь: октября
заглавный: заглавная
первый: первая первой
содержание: содержание
шлюпка: шлюпки
февраль: февраля
шекли: шекли
роман: романы
кошмар: кошмар
экран: экране
код: код
вскоре: вскоре
агентство: агентство
личность: личности
значение: значения
свой: своей
принести: принеси
битва: битва
необходимый: необходимая необходимого
этот: эта
возникнуть: возник возникшее
номер: номере
роберт: роберт роберта
желание: желаний
правка: правки
арнольд: арнольд
газ: газа
преуспеть: преуспеть
ироничный: ироничный
фантаст: фантаста
статус: статуса
жертва: жертва
закупорить: закупоренных
мнемон: мнемон
алфавит: алфавиту
год: года году
простой: простых
сожаление: сожалением
лаксианский: лаксианский
лавка: лавка
русский: русский
пожертвовать: пожертвовать
особый: особый
билл: билл
верить: верил
рассказ: рассказ рассказа рассказов рассказы
тантра: тантрой
язык: язык языках языке
добро: добро
некоммерческий: некоммерческой
серия: серия
сообщество: сообщество
заявление: заявление
ответственность: ответственности
персональный: персональные
отредактировать: отредактирована
минимум: минимум
система: системе
жанр: жанр
существовать: существуют
проверка: проверки
земной: земную земные
отправиться: отправился
экранизация: экранизации
дракониан: дракониан
сообщить: сообщить
имя: имя имён
фильм: фильма
избранный: избранные
википедия: википедии википедия
ссср: ссср
проверить: проверенной
лицензия: лицензии
исповедь: исповедь
демон: демона
форма: форма
грегор: грегор
ещё: ещё
фауст: фауста
гора: гора
театр: театр
муж: муж
чудо: чудес
впервые: впервые
пролететь: пролетела
повесть: повести
править: править
канонерка: канонерке
альтернатива: альтернатива
действовать: действовать
подробный: подробнее
ошибка: ошибке
пытаться: пытается
старательский: старательский
обсуждение: обсуждение
кук: куки
путешествие: путешествие
сцена: сцены
участие: участие
марьяж: марьяж
крапчатый: крапчатыми
лаборатория: лаборатории
запись: запись
форум: форум
харибда: харибдой
ловушка: ловушка
галактика: галактики
отыскивать: отыскивает
создать: создать
напоминать: напоминают
жить: жить
рейс: рейс
печать: печати
провести: провел
постоянный: постоянная
викидать: викиданных
юнга: юнгой
пространство: пространства
история: историей история
объяснить: объяснили
сюжетный: сюжетную
знак: знак
термин: термина
получить: получить
искать: искал
товарный: товарный
сюда: сюда
скачать: скачать
тягота: тяготах
локационный: локационным
оригинал: оригинала оригиналом
вклад: вклад
требовать: требуют
пожаловать: пожаловать
один: одного
опытный: опытными
воспоминание: воспоминания
сведение: сведения
обмен: обмен
общение: общении общения
другой: другие других
английский: английский английской английском
появиться: появился
поединок: поединок
неоспоримо: неоспоримо
соавторство: соавторстве
цитата: цитаты
опубликовать: опубликован
космос: космос
нога: нога
кромптон: кромптона
долой: долой
конец: конце
алина: алина
ласточка: ласточек
вдвойне: вдвойне
кардоман: кардоман кардоману
роль: роли
прекрасный: прекрасного
публикация: публикации
цитировать: цитировать
вариант: варианты
стандартный: стандартный
зарегистрировать: зарегистрированный
политика: политика
просмотр: просмотры
поделиться: поделиться
служба: службы
фургон: фургона
сборник: сборнике
цивилизация: цивилизация
голова: голову
новый: новое новые
выставка: выставки
выбор: выбора
участник: участниками
ностальгия: ностальгией
свежий: свежие
смотреть: см
подразделение: подразделением
любовь: любви
транай: транай
справка: справка
проверяться: проверялась
мемуары: мемуары
элемент: элемент
премия: премия
читать: читать
мы: нами
вспомнить: вспомнить
известный: известного
текущий: текущая текущие
хотеть: хотела
земля: землю
психиатр: психиатру
координата: координаты
кризис: кризис
спецраздел: спецраздел
прогулка: прогулка
официант: официанта
старт: старт
мобильный: мобильная
паразит: паразитов
менять: меняет
энциклопедия: энциклопедии
произведение: произведения
современный: современном
доступный: доступен
детективный: детективное
мир: миров
шаблон: шаблона
линия: линию
алхимический: алхимический
туземец: туземцев
источник: источник
рассказывать: рассказывал
учётный: учётную
стая: стая
короткий: короткий
потолковать: потолкуем
главное: главного
викимедиа: викимедиа
забавный: забавных
покидать: покидает
изображение: изображение
использование: использования
случайный: случайная
пока: пока
лечить: лечащего
бессмертие: бессмертие
автор: автор
фантастика: фантастики
категория: категории
информация: информация
хол: хол
молочный: молочного
отдельный: отдельных
десятый: десятая
седьмой: седьмая
отказ: отказ
проект: проектах
специалист: специалист
сохранение: сохранением
свободный: свободной
указание: указанием
конфиденциальность: конфиденциальности
связанный: связанные
дата: дата
вестерн: вестерн
врач: врача
поведение: поведения
юность: юности
корпорация: корпорация
разработчик: разработчики
дополнительный: дополнительные
это: это
разум: разумов
последний: последний
заметить: замечен
альдебаран: альдебарана
литературный: литературные
организация: организации
малость: малость
бухгалтер: бухгалтер
писать: писала
редкий: редкий
предел: предел
химия: химия
написание: написания
статистика: статистика
