мы: нами
василевс: василевс василевса василевсу
изображение: изображениями
уильям: уильям уильяма
инв: инв
смотреть: см смотрит
леди: леди
святой: святая
советник: советников
равенна: равенне
использовать: использующие
принадлежать: принадлежит
рим: рим
успокоиться: успокоившись
статья: статьи
картина: картина картине картины
занятый: занятый
энциклопедия: энциклопедии
птица: птиц птицами
изобразить: изображена изображён
гонорий: гонорий гонорию гонория
тёмный: тёмные
сентябрь: сентября
версияправитьправить: версияправитьправить
правкиновое: правкиновые
цвет: цвета
план: плане
перейти: перейти
создать: созданная
примечание: примечания
страницасодержаниеизбрать: страницасодержаниеизбранные
фаворит: фавориты
выситься: высится
навигация: навигации навигация
страница: страница страницы
слово: слова
отличаться: отличаться
аделаида: аделаида
википедия: википедии википедия
вандал: вандалами
римский: римского
статьятекущий: статьятекущие
год: года году
вероятный: вероятнее
статьисообществофорумсправкасвежий: статьисообществофорумсправкасвежие
птичник: птичника
ветер: ветер
огромный: огромный
печать: печати
жена: жена
первый: первого
пенелопа: пенелопа
политика: политика
имя: имени имён
записьвойти: записьвойти
обращение: обращение обращения
дополнительный: дополнительные
кесарийский: кесарийского
медиафайл: медиафайлы
расстояние: расстоянии
фонд: фонд
поиск: поиск поиску
страницуполучить: страницуполучить
язык: язык языках
галерея: галереи галерея
искусствекартина: искусствекартины
масло: масло
просмотр: просмотры
император: император императора императоры
свой: своих
художественный: художественная художественной
ссылкасведение: ссылкасведения
каир: каире
действовать: действовать
война: война
отказ: отказ
увлечение: увлечении
событияпожертвовать: событияпожертвовать
цирцей: цирцея
проверка: проверки
английский: английского
смотритель: смотритель
время: время
круг: круг
указание: указанием
дело: дело
роза: розы
пространство: пространства пространство
викисклад: викискладе
джон: джон джона
коврик: коврике
викимедиа: викимедиа
читатьтекущий: читатьтекущая
свободный: свободной
внимание: внимание
сон: сон
волшебный: волшебные
некоммерческий: некоммерческой
одиссей: одиссей одиссею
сирена: сирена сирены
сюжетыримский: сюжетыримские
декабрь: декабря
историк: историка
большой: велико
художник: художника
персональный: персональные
указать: указан
условие: условий условия
евнух: евнух евнухов
также: также
январь: января
магический: магический
рука: рук руки
авторство: авторства
волшебница: волшебница
юг: юге
правкипостоянный: правкипостоянная
материал: материал
дата: дата
отредактировать: отредактирована
ошибкекак: ошибкекак
столь: столь
русалка: русалка
который: которой
северный: северный
архивировать: архивировано
октавиан: октавиана
искусстведревний: искусстведревний
август: августа
срывать: срывайте
короткий: короткий
эхо: эхо
представиться: представились
являться: является
австралиискрыть: австралиискрытые
версия: версии версия
уотерхаус: уотерхаус уотерхауса
учётный: учётную
это: это
безжалостный: безжалостная
этот: эта
город: город
подумать: подумал
марианна: марианна
ясон: ясон
англ: англ
значительно: значительно
подробный: подробнее
разработчик: разработчики
знак: знак
отдельный: отдельных
использование: использования
стремиться: стремящихся
семьяэстера: семьяэстер
набросок: набросок
викискладэлемент: викискладэлемент
петух: петух
брат: брат
апрель: апреля
сообщить: сообщил сообщить
понять: поняв
кодистория: кодистория
связаться: свяжитесь
участник: участниками
код: код
страницецитировать: страницецитировать
шалот: шалот
проверяться: проверялась
определять: определяют
воскликнуть: воскликнул
статьяобсуждение: статьяобсуждение
прокопий: прокопия
годакартина: годакартины
ещё: ещё
нарцисс: нарцисс
викидать: викиданных
мочь: могут
проверить: проверенной
кормить: кормил
русский: русский
безрассудство: безрассудство
гиласа: гилас
заглавный: заглавная
труд: труда
группа: группа
поведение: поведения
кук: куки
правитель: правителя
нимфа: нимфы
уотерхаусакартина: уотерхаусакартины
дружище: дружище
громко: громко
статистика: статистика
южный: южной
свойство: свойство
евлалия: евлалия
последний: последний
текст: текст
судьба: судьба
заявление: заявление
ответ: ответ
мобильный: мобильная
править: править
шар: шар
ланселот: ланселота
сюдасвязанный: сюдасвязанные
опытный: опытными
смерть: смерть
ответственность: ответственности
собраться: собравшихся
медея: медея
говорить: говорят
кодекс: кодекс
светлый: светлые
категория: категории
тон: тона
инструмент: инструменты
погибнуть: погиб
алариха: алариха
системеобсуждениевкладсоздать: системеобсуждениевкладсоздать
одетый: одетая
офелия: офелия
сводный: сводный
лицензия: лицензии
оригинал: оригинала
страницыслужебный: страницыслужебные
ссылка: ссылки
задний: заднем
коллекция: коллекции
выставка: выставки
конфиденциальность: конфиденциальности
алфавитукартина: алфавитукартины
скорый: поскорей
бокал: бокал
исторический: исторические
западноримский: западноримский
византийский: византийского
хрустальный: хрустальный
октябрь: октября
собрание: собраний
товарный: товарный
зарегистрировать: зарегистрированный
привлечь: привлечь
кенуортить: кенуорти
сюжет: сюжет
ковёр: ковра
статьислучайный: статьислучайная
красавица: красавица
австралия: австралии
холст: холст
доступный: доступен
пандора: пандора
организация: организации
скачать: скачать
случай: случаях
пока: пока
проект: проектах
сцена: сцена
сохранение: сохранением
текущий: текущая
жених: женихи
описание: описание
участие: участие
оракул: оракулу
известно: известно
другой: других
уличный: уличная
заполнить: заполнить
требовать: требует
одежда: одежды
кормление: кормлением
культура: культуре
подавать: подаёт
сказать: сказал
источник: источник
правка: правка
часть: частью
статуя: статуя
