латос: латос
войти: войти
составлять: составляет
татарча: татарча
описание: описание
авторство: авторства
государственный: государственного государственном государственный
луктос: луктос
материал: материал
бассейновый: бассейнового бассейновому
мичкас: мичкас
пушт: пушта
сухой: сухой
поиск: поиск поиску
юзга: юзга
водный: водная водного водном водные водный водных
инструмент: инструменты
серганка: серганка
берег: берегу
страница: страница странице страницу страницы
сатис: сатис
кит: кита
водомерный: водомерного
парец: парца
район: район районе
атмисс: атмисс
камора: камора
тип: тип
представиться: представились
область: области область
варнава: варнава
ги: ги
муравка: муравка
текст: текст
кодекс: кодекс
сарма: сарма
лопужовка: лопужовка
запад: западу
том: тома
некрасовка: некрасовка
ред: ред
россия: россии россия
протекать: протекает
событие: события
варежка: варежка
случай: случаях
вязовка: вязовка
заполнить: заполнить
гуменка: гуменка
ресурс: ресурсов ресурсы
кутукс: кутукс
статья: статьи статья
кириклейка: кириклейка
чукалка: чукалка
скрытый: скрытые
служебный: служебные
вад: вад
южва: южва
условие: условий условия
версия: версия
окский: окского окскому
юловкий: юловка
вирушко: вирушка
волга: волга
цна: цна
округ: округа
перейти: перейти
связаться: свяжитесь
изученность: изученности изученность
викидать: викиданные викиданных
мердуша: мердуш
уркат: уркат
инница: инница
студенец: студенец
чепур: чепура
шиш: шишов
фонд: фонд
шалма: шалма
мочь: могут
тарс: тарса
навигация: навигации навигация
костыляйка: костыляйка
крутец: крутец
заглавный: заглавная
вячка: вячка
содержание: содержание
м: м
код: код
выпуск: выпуск
явас: явас
широта: ш
исток: исток
ведяж: ведяжа
этот: эта
муромка: муромка
относиться: относится
рф: рф
правка: правка правки
округа: округу
арх: арх
пичкиряса: пичкиряс
алфавит: алфавиту
данные: данным
темник: темников
русский: русский
пожертвовать: пожертвовать
год: лет
лячать: ляча
мокша: мокша мокши
язык: языках
некоммерческий: некоммерческой
мокшаня: мокшань
система: система системе системы
модаевка: модаевка
водоток: водоток
сообщество: сообщество
широкоис: широкоис
заявление: заявление
вадакша: вадакш
ответственность: ответственности
персональный: персональные
вшивка: вшивка
отредактировать: отредактирована
уновать: унуй
лопатин: лопатино
ссылка: ссылка ссылки
малый: малая малый
азясь: азясь
устье: устье устья
сообщить: сообщить
избранный: избранные
википедия: википедии википедия
объект: объекта объекты
тасть: тасть
ссср: ссср
гкгна: гкгн
лястьма: лястьма
лицензия: лицензии
медаевка: медаевка
ожг: ожга
нуловать: нулуй
федеральный: федеральным
летка: летка
ниже: ниже
шелдаиса: шелдаис
ялтамуса: ялтамус
модье: модьев
посёлок: посёлка посёлок
ещё: ещё
ломовка: ломовка
карточка: карточка
водохозяйственный: водохозяйственного водохозяйственный
шап: шапа
больший: большая
паньжа: паньжа
красноржавченка: красноржавченка
править: править
липлейка: липлейка
км: км
действовать: действовать
подробный: подробнее
регион: регион
пост: поста
ошибка: ошибке
рахманка: рахманка
мокрый: мокрый
гидрологический: гидрологическая гидрологической
пишляйя: пишляй
исправить: исправить
чалбай: чалбай
обсуждение: обсуждение
кук: куки
последний: последний последняя
реестр: реестр реестра реестре
андроновка: андроновка
саровка: саровка
шувард: шуварда
участие: участие
номер: номер
око: ока
река: река реки
канерг: канерга
деревня: деревни
запись: запись
форум: форум
виндрей: виндрей
тистеть: тистев
шадымка: шадымка
создать: создать
имя: имён
исса: исса
ермить: ермишь
сутки: суток
лиса: лиса
печать: печати
постоянный: постоянная
агентство: агентством
урей: урей
страна: страна
геокаре: геокаре
кевда: кевда
рязанский: рязанская рязанской
море: море
пространство: пространства
длина: длина
сивинь: сивинь
знак: знак
течь: течёт
получить: получить
авгур: авгура
толковка: толковка
товарный: товарный
характеристика: характеристика
сюда: сюда
скачать: скачать
карта: картами
варма: варма
районирование: районирования
вклад: вклад
речной: речной
так: т
ермишинский: ермишинский ермишинском
керка: керка
сведение: сведения
марчас: марчас
формат: формат
минприрода: минприроды
другой: других
июнь: июня
свестур: свестур
русый: рус
подбассейн: подбассейн
шабан: шабан
гвр: гвр
ламар: ламар
лепьевский: лепьевский
публикация: публикации
цитировать: цитировать
бассейн: бассейн бассейна
чечёрка: чечёрка
сиевка: сиевка
правый: правому
елисеевский: елисеевский
зарегистрировать: зарегистрированный
политика: политика
каурец: каурец
просмотр: просмотры
местоположение: местоположение
шавица: шавиц
город: города
свежий: свежие
смотреть: см
скачка: скачки
ивка: ивка
мерхляйя: мерхляй
справка: справка
новый: новые
элемент: элемент
ведж: веджа
кивчий: кивчей
координата: координат координаты
читать: читать
парк: парка
мы: нами
текущий: текущие
калдусс: калдусс
указать: указано
рябок: рябка
подготовить: подготовленной
история: история
атмис: атмис
сезёлка: сезелка
юнка: юнка
лавовый: лавов
инсарка: инсарка
мобильный: мобильная
урзев: урзева
большой: большой
удёвый: удёв
село: сёла
энциклопедия: энциклопедии
чиуш: чиуш
доступный: доступен
свойство: свойство
тростина: тростина
источник: источник
аксел: аксел
нежилой: нежилой
нурзев: нурзева
учётный: учётную
синняр: синняр
короткий: короткий
сеитьма: сеитьма
геоинформационный: геоинформационной
викимедиа: викимедиа
гидрометеоиздат: гидрометеоиздат
участок: участок
поверхностный: поверхностных
каспийский: каспийское
устаревший: устаревший
использование: использования
патра: патра
площадь: площадь
случайный: случайная
находиться: находится
три: трёх
вода: вод
категория: категории
астрочка: астрочка
кувакша: кувакша
отдельный: отдельных
высота: высота
лундать: лундан
отказ: отказ
проект: проектах
территория: территории
сохранение: сохранением
свободный: свободной
указание: указанием
конфиденциальность: конфиденциальности
расположение: расположение
связанный: связанные
дата: дата
поведение: поведения
разработчик: разработчики
дополнительный: дополнительные
бель: бель
потиж: потиж
шишкеевка: шишкеевка
изображение: изображений
дать: данные
котёл: котёл
примечание: примечания
организация: организации
карёнок: каренка
жабка: жабка
шуструя: шуструй
статистика: статистика
толкуляйя: толкуляй
