войти: войти
улучшить: улучшите улучшить
оставаться: остаются
попытка: попыток
италия: италией италии италия
поэтому: поэтому
описание: описание описанию
авторство: авторства
необходимо: необходимо
материал: материал
журнал: журнал
неясный: неясными
проверить: проверить проверьте
день: дня
симулировать: симулировали
впоследствии: впоследствии
иметь: имели имело
поиск: поиск поиску
менгес: менгес менгесу
раздел: раздел раздела разделами разделе
мост: мостов
распределённый: распределённые
осуществить: осуществлена
инструмент: инструменты
привести: приведённым
страница: страница странице страницу страницы
найти: найти
уделять: уделяет
вестись: велась вестись
теоретически: теоретически
обращение: обращения
другой: другим других другое
также: также
швейцария: швейцарии швейцарию швейцария
рассматриваться: рассматривалась
представиться: представились
предпринять: предпринято
подготовить: подготовил
факт: факт фактов факты
оперативный: оперативного
текст: текст
кодекс: кодекс
иначе: иначе
предприятие: предприятия
утверждение: утверждение
окончательно: окончательно
высадка: высадки
неповреждённый: неповрежденном
немецкий: немецкая немецким
существенный: существенный существенным
вторжение: вторжение вторжением вторжению вторжения
лев: лев
высокогорье: высокогорье
условие: условий условия условиях
событие: события
необходимость: необходимости
место: места
случай: случае случаях
фото: фото
армия: армию армия
заморозить: заморожена
источник: источник источника источникам источниками источники источников
взвесить: взвешенного
перемирие: перемирия
статья: статье статьи статью статья
безболезненно: безболезненно
безопасность: безопасности
примерный: примерная
скрытый: скрытые
служебный: служебные
план: плана планам планов планы
важный: важнейших важные
сср: сср
версия: версия
германия: германией германии германия
группа: группой
бессарабия: бессарабию
аспект: аспекта
который: которая которой которые которых
группировка: группировки
наведение: наведения
возможный: возможные
перейти: перейти
англ: англ
взвешенность: взвешенности
либо: либо
мнение: мнению мнения
война: войне войны
связаться: свяжитесь
исправить: исправьте
второй: второй
страна: страна странами страну страны
малозначимый: малозначимые
обсуждение: обсуждение обсуждения
некоторый: некоторые
переговоры: переговоры
гитлеровский: гитлеровские
операция: операции операция
советский: советским
пригодный: пригодной
варспот: варспот
архивировать: архивировано
бездействие: бездействия
золотурна: золотурн
менее: менее
фонд: фонд
заканчиваться: заканчивалась
отступление: отступление
удалённый: удалён
мочь: могли могут можете
навигация: навигации навигация
противостояние: противостояния
состав: состав
шаблон: шаблонами шаблоне
захват: захват захвата захвату
год: год года году годы
создать: созданная создать
дискуссия: дискуссию
вильгельм: вильгельм вильгельма вильгельму
нейтралитет: нейтралитет нейтралитета
учитывать: учитывал
быстро: быстро
октябрь: октябре октября
заглавный: заглавная
рекомендация: рекомендации
содержание: содержание
февраль: февраля
определить: определена определить
многочисленный: многочисленных
код: код
предусматриваться: предусматривалось
военный: военным военных
разработать: разработано разработать
известный: известных
сила: силу силы
её: её
такой: таких
участвовать: участвовали
оккупировать: оккупированными
завершать: завершающих
этот: эта
авторитетный: авторитетные авторитетными
одновременно: одновременно
четвёртый: четвёртая
направление: направлении
список: список
правка: правки
горный: горного горные
массив: массива
принцип: принцип
каждый: каждое
фактически: фактически
противный: противном
подтвердить: подтвердите
аре: аре
войско: войск войска войскам войсками
представлять: представляя
торговля: торговля
алфавит: алфавиту
информация: информацией информации информацию информация
русский: русский
занятый: занят
пожертвовать: пожертвовать
туннель: туннелей
производиться: производились
язык: языках
редут: редут
некоммерческий: некоммерческой
оригинальный: оригинальное оригинальный оригинальным оригинальных
водораздел: водоразделу
исследование: исследование исследованием исследований
итальянский: итальянские
осуществление: осуществление
британия: британию
сообщество: сообщество
заявление: заявление
подозревать: подозреваемые
дальнейший: дальнейшее
ответственность: ответственности
контролироваться: контролировалась
отто: отто
сражение: сражения
союзник: союзников
српски: српски
персональный: персональные
лукин: лукин
отредактировать: отредактирована отредактировать
различный: различные
союз: союза
линия: линия
система: систем системе
почему: почему
соответствие: соответствие соответствии
сложно: сложно
проверка: проверки
ссылка: ссылка ссылки ссылок
швейцарский: швейцарские швейцарский швейцарскую
являться: являющуюся
сообщить: сообщить
битва: битвой
морской: морской
занять: занять
избранный: избранные
википедия: википедии википедия
ссср: ссср
цюрих: цюрих
экономический: экономические
этап: этапах
лицензия: лицензии
немец: немцы
организовать: организованное
делаться: делалось
предприниматель: предприниматели
состояние: состоянии
дать: дал
ещё: ещё
максимально: максимально
удалить: удалена удалены удалите
пожалуйста: пожалуйста
нарушение: нарушением
сделать: сделать
юг: юге
стать: стали статей
германский: германских
потенциальный: потенциальному
достоверность: достоверность
возможно: возможно
фон: фон
неопр: неопр
общий: общим
подконтрольный: подконтрольными
править: править
ретикона: ретикон
назваться: назвалась
действовать: действовать
подробный: подробнее
вариант: вариант
ошибка: ошибке
поставить: поставлена
ель: ель
пояснение: пояснений
кук: куки
транспортный: транспортных
торпеда: торпед
буквально: буквально
содержать: содержит
участие: участие
сопротивление: сопротивление
название: названием
сноска: сноски сносок
запись: запись
форум: форум
конец: конца
министерство: министерства
мирный: мирном
планироваться: планировавшееся планировался
невозможный: невозможными
имя: имён
оборона: обороны
австрия: австрии
тип: типам
печать: печати
поскольку: поскольку
постоянный: постоянная
ход: ходе
перебросить: переброшены
королевство: королевство
викидать: викиданных
ущерб: ущерб
пространство: пространства
взаимоотношение: взаимоотношения
окружить: окружена
хотя: хотя
август: августа августе
железнодорожный: железнодорожных
знак: знак
отдельный: отдельное отдельных
получить: получить
намереваться: намеревался
генеральный: генерального
точность: точность
товарный: товарный
сюда: сюда
скачать: скачать
вклад: вклад
сайт: сайт
подразумеваться: подразумевается
ряд: ряд
нормандия: нормандии
один: одного
требоваться: требовалось
сведение: сведений сведения
изложить: изложенных
вооружённый: вооружённые
какой: какого
рассеять: рассеять
деталь: детали
осуществлять: осуществляли
изложение: изложения
атаковать: атакуют
июнь: июня
государство: государства
узел: узлов
тема: темы
выдвижение: выдвижение
нацистский: нацистская нацистской
июль: июля
этнический: этнической
гора: горы
мировой: мировой
муттлера: муттлер
соответствовать: соответствующую
цитировать: цитировать
весь: вся
противник: противник противнику
хватать: хватает
зарегистрировать: зарегистрированный
политика: политика
просмотр: просмотры
шарикоподшипник: шарикоподшипники
сомнение: сомнение
сей: сих
недостаток: недостатков
требовать: требует
сначала: сначала
проверять: проверяема
объяснение: объяснений
нужно: нужно
дивизия: дивизии дивизий
сентябрь: сентябре сентября
свежий: свежие
смотреть: см
справка: справка
новый: новые
территория: территориями
штаб: штаба
элемент: элемент
поручить: поручено
български: български
взять: взято
плюс: плюс
читать: читать
мы: нами
критерий: критериям
сохранять: сохраняла
неосуществлённый: неосуществлённые
командование: командованием
текущий: текущие
восточный: восточных
полностью: полностью
добавить: добавив
сам: самого самой
ввод: вводе
история: история
разрешение: разрешения
бомбардировка: бомбардировок
мобильный: мобильная
вхождение: вхождении
тёдить: тёди
существовать: существует
серьёзно: серьёзно
берн: берн
энциклопедия: энциклопедии
поставка: поставки
доступный: доступен
нарушать: нарушает
причина: причины
орган: орган
риттер: риттера
гитлер: гитлер
учётный: учётную
короткий: короткий
наличие: наличии
танненбаум: танненбаум
викимедиа: викимедиа
свой: свой
использование: использования
проходить: проходила
случайный: случайная
франция: францию
больший: большие
совершенно: совершенно
компьенский: компьенского
крупный: крупной
категория: категории
обновить: обновленный
проставить: проставив
отказ: отказ
немногочисленный: немногочисленные
проект: проектах
альпы: альпах
сохранение: сохранением
свободный: свободной
указание: указанием
центральный: центральных
конфиденциальность: конфиденциальности
связанный: связанные
слишком: слишком
правило: правилами
проход: прохода
транспорт: транспорта
дата: дата
поведение: поведения
должный: должна
подтверждать: подтверждающие
пора: пор
разработчик: разработчики
товар: товаров
несколько: несколько
вид: виде
дополнительный: дополнительные
это: это
последний: последний
немой: нем
примечание: примечания
организация: организации
рон: рона
третий: третий
выпуск: выпуски
написание: написания
южный: южную
статистика: статистика
