построить: построенной построенные построили
мы: нами
изображение: изображением изображениями
пострадать: пострадавшего пострадал
стать: ставшего ставшей стал стали стало
монументальный: монументальная
центр: центров
лестница: лестница
замок: замка замкам замке замки замком замку замок
ассоциация: ассоциаций
разместиться: разместился
масштабный: масштабную масштабные
специальный: специальным
захватить: захвачен
усиленный: усиленные
ворота: ворот ворота
леди: леди
эрнст: эрнст эрнста эрнстом эрнсты
южный: южное южной
верденберг: верденберг верденбергов
прюшенка: прюшенку
перейти: перейти перешло перешёл
мужской: мужского мужской
семья: семьи семья
католик: католиками
изящно: изящно
амфитеатр: амфитеатра
открыть: открыли открыты
общий: общий
животное: животных
рабочий: рабочий
площадка: площадка площадки площадкой
действовать: действовать действует
использовать: использовали использованы использующие
бухбиндер: бухбиндер
иметься: имеется имелся
амадей: амадей амадею
голубой: голубой голубым
возникнуть: возник
склад: склад
генрих: генриху
парадный: парадная парадный
война: войн войны
австрия: австрии австрию австрия
значительный: значительную значительный
деталь: детали
составной: составных
поздний: поздней позже
жёлтый: жёлтый
усадебный: усадебное
ров: рвов рвом рвы
йоханна: йоханн
семинар: семинары
гостиница: гостиница
фукс: фукс
графский: графской
фигура: фигура фигуры
статья: статьи
возраст: возраст
энциклопедия: энциклопедии
основный: основное
читатьправитьправить: читатьправитьправить
коммуна: коммуне
изменение: изменений изменения
реконструкция: реконструкцией реконструкцию реконструкция
бастион: бастионы
появиться: появились появился
дворянский: дворянской
перестроить: перестроенном перестроили перестроить
иосиф: иосифа
полёт: полёта
тот: той ту
разведение: разведению
графенэгге: графенэгге
частность: частности
состоять: состоит состоящая
настоящий: настоящего настоящему
обосноваться: обосноваться
директор: директор
ключ: ключе
объект: объект объекты
правкиновое: правкиновые
леопольд: леопольд леопольда
западный: западного западное западной западном
приобрести: приобрело приобрёл
деревянный: деревянном
ресурс: ресурсы
функционировать: функционирует
стена: стене стеной стены
целое: целом
фронтон: фронтоны
аркада: аркады
внутренний: внутреннее внутреннем внутренний
парк: парк парка парком
устроить: устроили
жалеть: жалел
широта: ш
сделать: сделана
официальный: официальная
оказаться: оказалась оказались оказался
примечание: примечания
вена: вене вены
страницасодержаниеизбрать: страницасодержаниеизбранные
собственник: собственник собственниками собственников
свой: своего своей своему своих свой своё
венский: венская венской
лоджия: лоджии лоджия
дом: дом дома домов
комната: комната комнаты
владение: владением владений
навигация: навигации навигация
первый: первое первом первый первых
восточный: восточная восточное восточной восточном восточному восточный
пора: поры
фондовый: фондовой
прославиться: прославившегося
руководство: руководством
внутри: внутри
страница: страница страницы
проходить: проходила проходили проходит проходят
серьёзный: серьёзные серьёзных
библиотека: библиотека библиотеки
завершиться: завершилась завершились завершилось
нижний: нижней нижняя
период: период
внести: внесенных внесли внёс
прямоугольник: прямоугольника
википедия: википедии википедия
бывший: бывшая бывший
существовать: существовавшим существовало существуют
различный: различные различных
реставрационный: реставрационные
год: год года годами годах годов году годы лет
располагаться: располагался
австрийский: австрийских австрийской
снести: снести
встроить: встроена встроенных
географический: географические
статьятекущий: статьятекущие
статьисообществофорумсправкасвежий: статьисообществофорумсправкасвежие
хозяин: хозяин хозяином
побеждать: побеждающего
павильон: павильона
огромный: огромный
печать: печати
убранство: убранство
ход: ходе
изначально: изначально
украсить: украсили украшен украшены
век: век века веке
относиться: относится
декорация: декорацией
политика: политика
ансамбль: ансамбль
кремс: кремс
внешний: внешние внешний
мировой: мировой
крупный: крупный крупных
ранее: ранее
имя: имени имён
фестиваль: фестиваль
руина: руины
открытый: открытым
слепой: слепая
записьвойти: записьвойти
эпизод: эпизоды
практически: практически
гербовый: гербовый
остальной: остальных
герб: герб гербы
ущерб: ущерб
фасад: фасад фасаде фасадов
зал: зал зале
конец: конце
медиафайл: медиафайлы
сцена: сцен сцену
максимилиан: максимилиан
работа: работ работе работы
недостаток: недостатка
периодически: периодически
сайт: сайт сайте
жизнь: жизни
северный: северного северное северной
экзотический: экзотические
неоготический: неоготического неоготическом
часто: часто
сад: сад садов
который: которая которого которой котором которые который
съёмка: съёмки съёмок
внушительный: внушительные
друг: друг другу
художественный: художественным художественных
агео: агео
помимо: помимо
засыпать: засыпаны
хозяйственный: хозяйственные хозяйственных
скульптура: скульптурами
гончий: гончих
концерт: концерты
разместить: размещены
фонд: фонд
боков: боковой
герцог: герцог герцогу
бык: быка
качество: качестве
очень: очень
восток: востоку
жилой: жилую жилых
находиться: находились находится находятся
утратить: утрачены
провести: провели
молочный: молочная
правда: правда
поиск: поиск поиску
расположить: расположен расположена расположенный расположены
потолок: потолка потолке потолки потолком
необарокко: необарокко
мюллер: мюллера
страницуполучить: страницуполучить
ведущий: ведущий ведущих
создать: создали созданный создать
военный: военной военные
язык: языках
выйти: вышла
сжечь: сожжены
галерея: галерея
подготовить: подготовить
пейзажный: пейзажный пейзажным
сооружение: сооружение сооружений сооружения
здание: здание зданий здания
основание: основания
турцо: турцо
граф: граф графа графам графов графы
украшение: украшения
решимость: решимость
центральный: центральной
дерево: дерева деревьев деревья
компания: компании
глубокий: глубокие
комплекс: комплекс комплекса комплексами
доверенный: доверенное
владеть: владеет
печь: печь
сын: сын сына сыне
решить: решил решили
доспех: доспехах
угловой: угловой угловые
театральный: театрального театральных
кирпич: кирпич
главное: главное
охранять: охраняемых
потерять: потеряли
каталог: каталогах
проводить: проводить
просмотр: просмотры
ложь: лжи
вестфальский: вестфальского
антропогенный: антропогенные
ссылкасведение: ссылкасведения
европа: европе
контроль: контролем контроль
алтарь: алтарь
десятилетие: десятилетий
линия: линии
верд: верда
роскошный: роскошный
результат: результате
выходить: выходящими
правильный: правильного
событияпожертвовать: событияпожертвовать
отказ: отказ
порода: пород породы
товарный: товарный
высота: высоты
три: тремя трёх
образец: образцом
хотя: хотя
телефильм: телефильм
оставаться: оставались
архитектор: архитектора архитекторами архитекторы
бройнера: бройнера
спальня: спальни
превращение: превращению
австриизамок: австриизамки
приказ: приказу
английский: английского
армия: армией армии армия
время: времени время
бернхард: бернхард бернхарда бернхардом
интересно: интересно
указание: указанием
кройценштайна: кройценштайн
викисклад: викискладе
двор: двор двора дворе
этот: эта этих
фердинанд: фердинанд фердинанда
тюдор: тюдоров
около: около
концертный: концертной концертном концертный
империя: империи империя
главный: главная
романтический: романтический романтического
публика: публики
включить: включены включила
викимедиа: викимедиа
башня: башней башню башня
стиль: стиле стиль
дизайн: дизайном
свободный: свободной
закончиться: закончились
яркий: яркие
посёлок: поселке
волшебный: волшебные волшебных
укрепить: укреплённую
графенегге: графенегге
некоммерческий: некоммерческой
школа: школа
совмещать: совмещавший совмещает
небольшой: небольшое небольшой
содержание: содержание
страна: страна
телеканал: телеканал телеканала
облик: облик
алфавитузамок: алфавитузамки
дворец: дворец дворца
верховой: верховой
баптист: баптист
ванная: ванная
согласно: согласно
штаремберг: штаремберга штаремберги
ландшафтный: ландшафтные
украшать: украшает
вода: воде водой
завершение: завершения
клуб: клубов
персональный: персональные
смерть: смертью
вернуть: вернув
принц: принцу
исключение: исключением
младший: младшая
воинский: воинские
использование: использование использования
постройка: построек постройкам постройки
условие: условий условия
могущественный: могущественного
украсть: украдены
салон: салон салоном
приусадебный: приусадебном
также: также
мельница: мельница
башенка: башенки
форма: форме формы
территория: территории
вмещать: вмещает
угол: углам углу
два: двух
кожа: кожа
серьёзно: серьёзно
окружить: окружили окружён
дьявол: дьявол
дух: духе
металл: металла
поэтому: поэтому
несколько: нескольких несколько
джон: джон
полыхать: полыхал
реализовать: реализованы
помещение: помещение помещении помещений
авторство: авторства
возвести: возведена возвели
отнестись: отнеслась
крыло: крыла крыле крыло крылу крыльев крылья
поддержка: поддержке
дата: дата
материал: материал материалы
фон: фон
виктор: виктор виктору
весна: весной
её: её
правкипостоянный: правкипостоянная
другой: другие других
название: название
пресечься: пресеклась пресёкся
крепостной: крепостные
мидлсекс: мидлсекс
верхний: верхнем
изготовить: изготовлены
превышать: превышает
фильм: фильма фильмов
отредактировать: отредактирована
февраль: февраля
ошибкекак: ошибкекак
собственность: собственность
нынешний: нынешнего нынешний
кровавый: кровавый
экспозиция: экспозиции
отделка: отделка отделки
государственный: государственная государственных
место: мест месте местом
ульрих: ульриха
вид: вид виде видов
обшивка: обшивки
предок: предков
графенегга: графенегг графенегга
ремонтный: ремонтные
возобновиться: возобновились
столовая: столовая
иоганн: иоганн иоганна
мощный: мощную
вершинескрытый: вершинескрытые
поселение: поселение
литература: литература
звукорежиссёр: звукорежиссёра
август: август августа
укрепление: укрепления
библиографический: библиографических
твикнемой: твикнема
особенность: особенностей
короткий: короткий
отец: отца
бергфрид: бергфрид
будущий: будущий
огненный: огненный
представиться: представились
уникальный: уникальной
являться: является
франц: франца
надолго: надолго
проект: проект проектах
купол: купол
старинный: старинная старинный старинных
покинуть: покинули
управлять: управляющего управляющий
флориан: флориана
тогдашний: тогдашнего
анфилада: анфиладу
учётный: учётную
итог: итоге
таверна: таверна
это: это
инициатор: инициатором
изображать: изображают
архитектурный: архитектурный
часть: частей части часть
многочисленный: многочисленные многочисленными
бартизать: бартизаны
культурный: культурных
гроссбергер: гроссбергер
рыцарский: рыцарский рыцарских
устроительство: устроительства
второй: второй
лондон: лондона
начаться: начались
пианист: пианист
называть: называемый называют
имение: имение имения
подробный: подробнее
знак: знак
бережно: бережно
разработчик: разработчики
акустика: акустикой
академия: академией
отдельный: отдельных
список: списке список
угроза: угроза
особенно: особенно
посадка: посадки
член: членами
гротескный: гротескные
конференция: конференции
предмет: предметы
круглый: круглой
дизайнер: дизайнеры
немой: нем
мода: моду
иной: иной
получить: получил получило
снимать: снимали
прежний: прежний прежних
земля: земле
великолепный: великолепной
стеклянный: стеклянное
управление: управлением
викискладэлемент: викискладэлемент
хардэгга: хардэгг
светский: светского
администрация: администрации
однако: однако
наполеоновский: наполеоновских
рыцарь: рыцарей рыцаря
некоторый: некоторые некоторых
смелый: смелым
оставить: оставив оставлен
ферма: ферма
мост: мост
аниф: аниф
выставка: выставка выставки
барокко: барокко
вторжение: вторжений
магазин: магазин
сторона: сторон стороны
протяжение: протяжении
владелец: владелец владельцев владельцы
ежегодно: ежегодно
архитектура: архитектуры
слушатель: слушателей
статуя: статуй статуя
самый: самые самых
примыкать: примыкает примыкающей примыкающих
ангел: ангелов
поместье: поместье
облачный: облачную
эпоха: эпоха эпохи эпоху
эсперсдорф: эсперсдорф
основатель: основателем
консольный: консольные
одноэтажный: одноэтажные
сообщить: сообщить
потомок: потомка
собака: собак
бумага: бумаге
адвент: адвент
остаться: остались остался
замковый: замковая замковом замковый
посвятить: посвящённую
эркер: эркерами
кодистория: кодистория
восстановление: восстановление
связаться: свяжитесь
текущий: текущем
резиденция: резиденции резиденцию
особняк: особняк
код: код
внешне: внешне
страницецитировать: страницецитировать
средство: средств
вокруг: вокруг
округ: округе
бройнер: бройнер
власть: властей
фигурный: фигурные
автор: автором
ранний: ранний
фреска: фрески
известный: известный известных
крах: краха
малый: малый
вход: вход входа входом
статьяобсуждение: статьяобсуждение
один: одним одной
постоянный: постоянные
ещё: ещё
агат: агаты
родовой: родовые
достигать: достигает
выступать: выступал выступающие
династия: династия
окраина: окраине
временной: временные
викидать: викиданных
оккупационный: оккупационной
постепенный: постепенные
мочь: могут
садовый: садовой садовый
заполнить: заполнили заполнить
русский: русский
ренессанс: ренессанс
книга: книг
интерьер: интерьерам интерьеров интерьеры
англия: англии
сторожка: сторожка
лицо: лицо
распорядиться: распорядился
дендрарий: дендрарий
сериал: сериала сериалов
небо: небом
хвойный: хвойные хвойных
векедостопримечательность: векедостопримечательности
изобразить: изображены
счёт: счёт
ремонт: ремонт
сохраняться: сохранялась
упоминаться: упоминается
род: рода
изящный: изящный
годувикипедия: годувикипедия
радикально: радикально
подписание: подписания
войти: вошедшего
больший: большая
графиня: графини
пресвятой: пресвятой
мария: марии
любить: любили
скончаться: скончался
группа: группа
поведение: поведения
сохраниться: сохранившаяся сохранились сохранилось сохранился
кук: куки
родиться: род
камень: камень
маленький: маленькая
полный: полных
святой: святого
гектор: гекторов
состояние: состояние состояния
конфликт: конфликт
послужить: послужила
графенэгга: графенэгг графенэгга
дамский: дамский
замужество: замужество
расширить: расширен
турнирный: турнирных
статистика: статистика
уместный: уместны
лето: лета
ярмарочный: ярмарочной
советский: советские советской
ветвь: ветви ветвь
история: история
новый: новый
середина: середине
ратиборский: ратиборскому
ланда: ланд
свойство: свойство
телесериал: телесериала
священный: священная
образовать: образующих
культура: культуре культуры
именоваться: именоваться
тема: теме
последний: последний последняя
возможность: возможность
езда: езды
феод: феодом
важный: важнейших
текст: текст
резной: резной
отреставрировать: отреставрирован
османский: османской
заглавный: заглавная
прекрасный: прекрасным
пол: пола
одноимённый: одноимённой
кровь: кровь
заявление: заявление
причинить: причинён
тип: тип типу
задумка: задумки
мобильный: мобильная
арнонкура: арнонкур
габсбург: габсбургов
элемент: элементы
править: править
навес: навесом
обучать: обучающие
высаживать: высаживали
пригласить: пригласили
сюдасвязанный: сюдасвязанные
венчать: венчают
фортификационный: фортификационные
себя: собой
ответственность: ответственности
затем: затем
резко: резко
термин: термина
готика: готики
обнаружить: обнаружить
обновить: обновлённой
усадьба: усадьбу
недалеко: недалеко
растение: растения
среди: среди
служить: служил служило
кодекс: кодекс
версия: версия
памятник: памятников
категория: категории
толстый: толстые
мрамор: мрамор
историзм: историзм историзма
инструмент: инструменты
служба: службы
карточка: карточка
наследница: наследниц
викиданныхстраница: викиданныхстраницы
этаж: этаже
туалетный: туалетная
дочь: дочери
системеобсуждениевкладсоздать: системеобсуждениевкладсоздать
артиллерия: артиллерией
разбитый: разбит
крепость: крепости крепость
римский: римская
фридрих: фридриха
графенэггнуть: графенэггнем
благополучно: благополучно
оккупация: оккупации
республика: республики
карта: картами
декоративный: декоративный
замуж: замуж
упоминание: упоминание
спроектировать: спроектировали спроектированный
хуго: хуго
многие: многие
документ: документам
парка: парке
местоположение: местоположение
лицензия: лицензии
граффенэгга: граффенэгг
дворцовый: дворцового
хардегга: хардегг
начало: начале
пространство: пространства
несмотря: несмотря
алфавитупро: алфавитупро
продать: продал продать
птичий: птичьего
гарнизон: гарнизон
стефан: стефана
бюро: бюро
мебель: мебель
смениться: сменилось
звание: звания
страницыслужебный: страницыслужебные
ступенчатый: ступенчатые
вновь: вновь
ссылка: ссылки
тридцатилетний: тридцатилетней
богато: богато
представитель: представителей
театр: театра
завершить: завершена
ссср: ссср
канцлер: канцлер
четыре: четырёх
отдать: отдал
конфиденциальность: конфиденциальности
сам: самом
музыкальный: музыкальных
прямо: прямо
музей: музей
прототип: прототипом
смотреть: см
проведение: проведения
состав: состав
изразцовый: изразцовая
срок: срок
сниматься: снимались
достаться: достался
массовый: массовой
дополнительный: дополнительные
снаружи: снаружи
современно: современно
десять: десять
предусмотреть: предусмотрен
каждый: каждом
настенный: настенной
рудольф: рудольф
зарегистрировать: зарегистрированный
значение: значения
ненадолго: ненадолго
большинство: большинство
герхард: герхард
выкопать: выкопали
винный: винный
густав: густава
реставрация: реставрации
духовный: духовного
начать: начал
посещение: посещения
корвейский: корвейскому
она: неё
бенигна: бенигна
графенэгг: графенэггом
слева: слева
гогенлоэ: гогенлоэ
май: мае
современный: современного современный
крестьянин: крестьян
капелла: капелла капеллу
статьислучайный: статьислучайная
размещаться: размещались
замечательный: замечательным
праздник: праздник
кабинет: кабинет
камин: камина
вернуться: вернулся
доступный: доступен
ценный: ценные
руководить: руководил
организация: организации
федеральный: федеральных
отличаться: отличается
необычный: необычной
ратибор: ратибор
богатый: богат
скачать: скачать
визитный: визитная
площадь: площадь
средний: средние
случай: случаях
кроме: кроме
энкефорт: энкефорт
большой: большой
вотчина: вотчиной
контрастировать: контрастирует
орнамент: орнамент
геркулес: геркулеса
чей: чья
произрастать: произрастает
деревня: деревня
часовня: часовни
сожаление: сожалению
вклад: вклад
биржа: биржи
сохранение: сохранением
установить: установлена
графство: графства
идти: идущий
статус: статус
мероприятие: мероприятий
описание: описание
наряду: наряду
троица: троице
карлхайнец: карлхайнца
участие: участие
роспись: росписи
портрет: портрет
известно: известно
строительство: строительство
император: императора
выкупить: выкупил
представлять: представляли
декорировать: декорированы
мир: мира
совершенно: совершенно
лестничный: лестничная
каменный: каменный
край: краям
рядом: рядом
протестант: протестантами
мартин: мартина
научный: научные
источник: источник
эстрада: эстраде
адольф: адольфа
частный: частная
правка: правка
продолжаться: продолжались
реконструировать: реконструировали
