феззана: феззана
рейх: рейх рейха рейхе рейхом рейху
магдалена: магдалена
мияно: мияно
реалист: реалист реалистов
сын: сын сына сыне сыновей сыном
внук: внук
переиздать: переизданную
посетить: посетил
адриан: адриан
новый: новая новое новой новую новые новый новым
журнал: журнал журнала журнале
глаз: глаз глаза глазами
принц: принц принца
проигрывать: проигрывает
умэхара: умэхара
ощущение: ощущение
золотой: золотые
впоследствии: впоследствии
появиться: появились появится
анно: анно
наживаться: наживающаяся
герой: героев герои герой героя героями героях
вещь: вещи
культ: культ культа культом
стремление: стремление стремлением стремления
разойтись: разошёлся
скончаться: скончался
второй: вторая второго второй втором вторую вторые вторым
террор: террора
флагман: флагман флагмане флагманы
смотреться: смотрелась смотрится
маленький: маленького меньше
политика: политика политики политикой
заканчиваться: заканчивается
несмотря: несмотря
дело: делам делами деле дело
найти: найти нашло
жизнь: жизни жизнь жизнью
эйю: эйю
летний: летние
полка: полка
скрытый: скрытой скрытые
министр: министр министра министров министром
вылиться: вылившийся
последний: последнего последней последнем последний последних последняя
розалина: розалин
убить: убившего убил убит убить
пират: пиратами пиратов пираты
мудрость: мудрость
пилот: пилотов
убийство: убийство
нанести: нанести
раса: расы
подчинённый: подчинённых
предложение: предложению
вероломство: вероломстве
танака: танака танаке танаки танакой
могила: могилу
сражение: сражение сражением сражений сражения сражениями сражениях
династический: династической
галактический: галактическая галактический галактического галактической галактическом галактическую
сюжет: сюжет сюжета
взять: взял взят взято взять
нетитулованный: нетитулованных
создаваться: создавалась
личный: личные личных
напиток: напиток
графический: графических
два: две двух
бессмысленно: бессмысленно
дворянский: дворянского дворянской
вес: весом
стирка: стиркой
ежегодник: ежегодник
металл: металл
фон: фон фоны
нажива: наживе наживы
женщина: женщина женщину женщины
последствие: последствиях
траншея: траншеи
достаточный: достаточного
понять: понять
позволять: позволяя
носить: носит
идея: идеей идеи идей идея идеями идеях
чрезмерный: чрезмерную
сделать: сделанной сделать
время: времена времени время времён
человек: людей люди людьми людях человек человека человеком
председатель: председатель
оно: оно
внутри: внутри
становиться: становится становятся
командовать: командовал
сверхчеловеческий: сверхчеловеческий
народный: народным
старший: старше старшей старшим старших старшую
хильдегард: хильдегарда хильдегарде
мик: мики
система: система системе систему системы
случай: случае случая случаях
карта: карту
третий: третий третьем третьи третьим
зло: зла зло злом
больно: больно
тактический: тактических
народ: народ народом
справедливость: справедливость
победа: победы
тезис: тезис
главное: главное
политический: политические политических политической политическом политическую
реалистичный: реалистичный
син: син
мочь: мог могла могли могло могут
мировой: мировая мировой мировую
ааре: ааре
конституция: конституцию
указ: указ указом
написать: написал написали написанные написанных написать
внебрачный: внебрачная внебрачной
корысть: корысти
романтик: романтик романтиков
прямо: прямо
судьба: судьба судьбой судьбы
фильм: фильм фильма фильмах фильме фильмов фильмы
почтовый: почтовыми
путеводитель: путеводитель
ядерный: ядерную ядерный
свой: своего своей своему свои своим своими своих свой своя своё
лидер: лидер лидера лидеры
важный: важна важное важные
щенок: щенка
нервный: нервного нервное нервной
правительство: правительства
ячейка: ячейку
честолюбивый: честолюбив
корабль: корабле кораблей корабли корабль корабля кораблями кораблях
ая: ая
шёнкопф: шёнкопф шёнкопфа
согласиться: согласился
занимать: занимает
вызвать: вызвать
эпитафия: эпитафии
шуберт: шуберт
считать: считает считали считать считаю
близкий: ближайший близки близкий близок
ускорять: ускоряет
анимация: анимацией анимации анимацию анимация
приказ: приказ
брат: братьев
стать: став ставшая ставшие стал стала стали станет стать
империя: империей империи империй империю империя
теракт: теракте терактов
заверять: заверяя
являться: является являлась являлся являются являясь
либо: либо
миллион: миллионов
бандзё: бандзё
мнение: мнение мнению
хозяин: хозяев
осведомить: осведомлён
продолжительность: продолжительность продолжительностью
компьютерный: компьютерная компьютерные компьютерных
война: войн война войнах войне войну войны
земля: земле земли земля
настоящий: настоящее настоящей
отличительный: отличительный
освободить: освободить
призрак: призрак
больший: большая большее большим большими большую
слух: слухи
исключительно: исключительно
частность: частности
продвигаться: продвигается
основный: основного основное основным основными основных
каждый: каждого каждом каждый каждым
бескровно: бескровно
мечтать: мечтает мечтал мечтающий
сторона: сторон сторона сторонам сторонах сторону стороны
огур: огура
конкурент: конкурента
кровожадный: кровожадный
архивировать: архивировано
обама: обамы
общий: общей общий
операция: операцию
враждовать: враждующим
юность: юность
мир: мир мира мире миру
митихара: митихара митихары
фонд: фонд
связать: связана связано
томока: томоки
сэйя: сэйю
комплект: комплект
рваный: рвано
пример: пример примеров примером примеры
удостоить: удостоены
приступ: приступа
демонтировать: демонтировать
увертюра: увертюра
отдел: отдела
военный: военная военного военное военной военную военный военным
сайт: сайт сайта сайте
детский: детское
поздний: позже
динар: динаров
генетически: генетически
юкиноб: юкинобу
отставка: отставку
монархия: монархии монархия
репрессия: репрессии репрессий
состав: состав составе
продолжаться: продолжалась
высокий: высоких высокого высокую
быстрый: быстрее быстрые
радость: радости
захват: захвата
завоевание: завоеванием завоевания
самый: самая самое самый самым самыми самых
опубликовать: опубликован опубликованных
заключить: заключил
чудесно: чудесно
противопоставить: противопоставлена
геринг: геринг
фанат: фанаты
рейтинг: рейтинг рейтинга
кгб: кгб
подобный: подобная подобной
ниндзя: ниндзя
февраль: февраля
буря: бури
предатель: предателем предателя
германофил: германофилом
экран: экране
ас: асами
выпуск: выпуск выпуска выпуски выпуском
хорикава: хорикава хорикавой
вскоре: вскоре
область: областях
ответ: ответ
сценарист: сценарист
убедить: убеждены
заменить: заменила заменить
кэидзый: кэидзо
цветок: цветы
физика: физику
сильный: сильнейшее сильный
рука: рук рука руках руки рукой
лоэнграмма: лоэнграмм лоэнграмма лоэнграмме
личность: личности
вальтер: вальтер вальтера
синъитиро: синъитиро
гражданин: граждан гражданам
любимый: любимый любимыми
призывать: призывает
работа: работа работах работой работы
серьёзный: серьёзной серьёзным серьёзными
битва: битв битва битвах битве битвы
территория: территорию
тирания: тирании
этот: эта этому
одежда: одежде
одновременно: одновременно
телесеть: телесеть
выглядеть: выглядеть выглядит
жаждать: жаждет
группировка: группировок
лёд: льда
иметь: имевшие имеет имел
известный: известна известная известного известных
подробный: подробнее подробной
правка: правка правки
евангелина: евангелине
портрет: портрет
ради: ради
савано: савано
сми: сми
гитлер: гитлер гитлере
оказаться: оказался
дастить: дасти
музыкальный: музыкальная музыкальное музыкальных
интересный: интересное интересном
похожий: похожей похожую
фактически: фактически
скучно: скучно
внимание: внимание внимания
очередь: очередь
аудитория: аудитории аудиторию аудитория
полководец: полководца полководцем
информация: информации
отговаривать: отговаривает
осуществлять: осуществляет
поражение: поражение поражения
представить: представить представлена
хося: хоси
федерация: федерации федерация
год: год года годах годов году годы лет
рассказчик: рассказчик
фаворитка: фавориткой
вручную: вручную
попытка: попытках попытке попытки
поневоле: поневоле
флагманский: флагманский флагманского
единственный: единственная единственное единственные единственный
демократический: демократический демократического демократическом
суша: суше
исследование: исследований исследования
коварный: коварен коварный
исполнитель: исполнитель
знакомить: знакомят
серия: серией серии серий серия сериях
подходящий: подходящая
сообщество: сообщество
заявление: заявление
признавать: признаёт
акиёсить: акиёси
роф: роф
май: мая
впечатляющий: впечатляющий впечатляющим
беседа: беседы
сблизиться: сблизился
опухоль: опухолью
персональный: персональные
свет: свете
литература: литература
межзвёздный: межзвёздная межзвёздные
постоянно: постоянно
гангрейв: гангрейв
коробка: коробках
такой: такая такие таким таких такого такое
тот: те тех
сценарий: сценарий сценарию
дюна: дюну
мастер: мастер
великий: великий великим великого
волков: волков
композитор: композитор композиторов
клаус: клаусу
действие: действие действий действия действиями действиях
литературный: литературном литературные
гэн: гэн
ухудшить: ухудшили
инцидент: инцидент
википедия: википедии википедия
азимов: азимова
выходить: выходил выходили выходит
оказываться: оказываются
активация: активации
непобеждённый: непобеждённые
европейский: европейская европейской
фактический: фактический
насчитывать: насчитывала
познакомиться: познакомилась познакомился
настать: настало
реализовать: реализованную реализовать
переход: переход
который: которая которого которое которой которому которую которые который которым которых
полномасштабный: полномасштабную
могущественный: могущественной могущественным
тацуюк: тацуюки
издаваться: издавались издавалось издавался
состояние: состоянии
уничтожить: уничтожена уничтожил
ещё: ещё
сословие: сословия
грандиозный: грандиозный
камосит: камосита
массовый: массового
оба: оба обеим обеих
масштабный: масштабного масштабной масштабные
метод: методы
гора: гора
подготовка: подготовке подготовку
столица: столица столице столицы
перейти: перейти перешла перешёл
откровенный: откровенной
сбить: сбил
признаться: признался
эрвин: эрвина
данный: данном
сигизмунд: сигизмунд сигизмунда
хотеть: хотел хотели хочет
оберштайна: оберштайн оберштайна
поиск: поиск поисках поиску
готэма: готэма
русский: русская русский
следовать: следует следуют
возможно: возможно
следующий: следующего следующие
век: век века веке веков
перспектива: перспектива
неоднократный: неоднократные
мятежный: мятежная мятежных
неопр: неопр
совершить: совершившего совершил
уничтожение: уничтожением уничтожению уничтожения
памятник: памятник памятнике
служить: служил служит служить
кризис: кризисе
создать: создавший созданные созданный созданными созданы создать
стараться: старался стараются
барбаросс: барбаросса
сёдзё: сёдзё
действовать: действовать действующих
хороший: лучшая лучшее лучший лучшими лучших хорошего хорошей хорошие хорошим
декабрь: декабря
като: като
пост: пост поста посту
волшебник: волшебник
эвакуация: эвакуации
счастливый: счастливый
оригинальный: оригинальной оригинальный оригинальных
молодой: молодого молодой молодых
хайнессный: хайнессен
менять: менял
николас: николас
правильный: правильным
сохраниться: сохранилось
фраза: фраза
возвращаться: возвращается
закулисный: закулисные
эп: эп
компенсировать: компенсирует
прусский: прусского
определённо: определённо
спасательный: спасательную
добавить: добавил
владимир: владимиром
любой: любая любом любую
участие: участие участии
чжугэ: чжугэ
гиперион: гиперион
цивилизация: цивилизации цивилизаций
поле: полях
лис: лис
иоахим: иоахим
внеземной: внеземных
приём: приёмам
рудольф: рудольф рудольфа рудольфе рудольфом
перехват: перехвата
никто: никому
кадр: кадры
рассказать: рассказать
придерживаться: придерживался
имя: имена имя имён
власть: власти власть властью
представитель: представителей представители представителя
начать: начал начали начатую
прошлый: прошлой
подход: подход
относиться: относиться
всемирный: всемирной
организовать: организовали организованного организованную
противозаконный: противозаконного
противник: противников противником
постоянный: постоянная
слабость: слабость
прогнить: прогнивший
прозвище: прозвище прозвищу
кацудзь: кацудзи
достоинство: достоинств достоинство
атрибут: атрибуты
кулак: кулак
желание: желание
завет: завета
быть: будете будут будучи
зигфрид: зигфрид зигфрида зигфриде зигфридом
агриппа: агриппа
райхард: райхарда
друг: друг друга другом другу друзьями
история: историей истории историю история
влияние: влияние влиянии
канцлер: канцлер канцлеру
приёмный: приёмный
море: море
полный: полная полного полное полной
сравниться: сравнится
бренди: бренди
потоковый: потоковый
сестра: сестра сестру сестры
джасть: джасти
возглавить: возглавил возглавить
предложить: предложил предложить
знак: знак
создавать: создавали
напряжение: напряжение
иноуэ: иноуэ
отличие: отличие
разочаровываться: разочаровывается
продать: продал продана
говорить: говорит говорить говоря
момент: момент момента
источник: источник источники
подбить: подбит
строить: строить
маркетинговый: маркетинговая
розенриттер: розенриттеров
намного: намного
арестовать: арестован
конфликтовать: конфликтуют
аттенборо: аттенборо
верный: верному верный верным
айзек: айзека
роман: роман романа романов романы
космический: космическая космические космический космическими космических космической космическом космическую
произойти: произойти произошли произошло
явно: явно
подчёркивать: подчёркивавшей подчёркивает
дружба: дружба дружбы
митио: митио
мелодия: мелодии
чингисхан: чингисханом
пехотный: пехотного
коррупция: коррупцией
глава: глава главой
пижонство: пижонства
другой: другие других другого
подавить: подавил подавленным
заплатить: заплатили
цель: целей цель целью
юитиро: юитиро
способность: способности
историография: историографией
српскохрватски: српскохрватски
мать: матери мать
прочитать: прочитают
привносить: привносят
вырастить: вырастить
тудаковы: тудаков
пустыня: пустыне
клементс: клементс
неприступный: неприступную
июнь: июня
вдохновение: вдохновения
объединение: объединении
заметно: заметно
взбунтоваться: взбунтовавшимся
германский: германская
песня: песни
конисикава: конисикава
кэй: кэй
выход: выхода
японский: японская японских японского японской японском японскую
динамичный: динамичны
мы: нам нами
житель: жители
закончиться: закончились
экранный: экранных
значение: значение
выигрывать: выигрывают
обвинение: обвинению
регулярно: регулярно
сочинение: сочинений
основатель: основатель основателю
адмирал: адмирал адмирала адмиралах адмиралов адмиралом адмиралу
хватать: хватает
соотношение: соотношении
данные: данных
александр: александр александра александре александром
толстовский: толстовское
отец: отец отца
мелкий: мелкого
достигнуть: достиг достичь
осознавать: осознавали осознаёт
циник: циник
тяга: тягу
белобрысый: белобрысого
статья: статьи статья
тщательно: тщательно
приобрести: приобрела
искусственный: искусственные
анимационный: анимационные анимационный
меч: меча
покончить: покончил
сентябрь: сентября
наоюк: наоюки
отаку: отаку
показ: показ показа
талантливый: талантливый талантливых
командование: командование командованием
мастерский: мастерскому
минец: минца минцем
подружиться: подружился
пара: пару
звезда: звезду звезды звёзд звёзды
удалённый: удалённые
нападение: нападения
нарит: нарита
роль: роль
мало: мало
рё: рё
сервис: сервис
язык: язык языках языке
осама: осаму
штаб: штаба
отчасти: отчасти
например: например
акинорь: акинори
канат: канату
сезон: сезон сезонами сезоне сезонов сезоны
домой: домой
отвергнуть: отвергнут
противостояние: противостояние противостоянии
закончить: закончить
вперёд: вперёд
доступный: доступен доступнее
имперский: имперскими имперских имперского имперскому имперскую
сам: сама самого самом
борьба: борьбе борьбы
накамур: накамура
республика: республика республике
подготовить: подготовленной
использовать: используемых используют использующие используя
отпечаток: отпечаток
сработать: сработало
карл: карл
воевать: воевал воевать
тягостный: тягостна
около: около
глупый: глупым
хидэюк: хидэюки
покушение: покушение покушения
колонизация: колонизации
акт: актом
кинотеатр: кинотеатрах
мобильный: мобильная
мощный: мощных
позиция: позиция
метрополис: метрополис
подняться: подняться
старый: старой
ходить: ходили
честь: чести честь честью
дальнейший: дальнейшем
оставаться: оставалось оставался оставаться остаётся
любовь: любви любовь
преемник: преемник преемником
ясухиса: ясухиса
подавление: подавлении подавления
произведение: произведение произведению произведения
прислушиваться: прислушиваться
играть: играют
захватывать: захватывающий
рамка: рамки
кинематография: кинематографии
изерлоно: изерлон изерлона изерлоне
возможный: возможного возможным возможных
бог: бога
сянъян: сянъяна
акир: акира
столько: столько
переехать: переехал
планета: планет планета планете планеты
держаться: держаться
осознание: осознанием
напоминать: напоминает напоминают напоминающий напоминая
желать: желал желая
присутствовать: присутствует
обычно: обычно
учётный: учётную
истощение: истощения
кацук: кацуки
обязательно: обязательно
руководство: руководство
гений: гением
соперник: соперников
жёсткий: жёстче
короткий: короткий
викимедиа: викимедиа
аналогичный: аналогичные
демонстрировать: демонстрирует
повествование: повествование повествования
начало: начала
мультсериал: мультсериалов мультсериалы
разнородный: разнороден
коррумпировать: коррумпированные
очень: очень
американский: американских американской американском
прежний: прежней прежним
собственный: собственного собственную собственные собственным
снаружи: снаружи
выдающийся: выдающийся
создатель: создатели
негромкий: негромких
звёздный: звёздной звёздные звёздных
героизм: героизмом
основной: основной основные
ход: ход ходе
верность: верности верность
иметься: имеется имеются
нобурый: нобуро
вэньть: вэньли
союз: союз союза союзе
дубляж: дубляжа
школьный: школьные
эпический: эпических
погибший: погибшего
собрание: собрание
современный: современного современные современный современных
основать: основал основан
база: базе базу
отказ: отказ
эйзенштейновский: эйзенштейновский
происходить: происходит происходящее происходящим
неполноценный: неполноценный
произвести: произвели
сохранение: сохранением
мечта: мечта
крайний: крайней
будущее: будущего будущее будущем
антураж: антураж
кровь: крови кровь
связанный: связанные
аниме: аниме
заказ: заказам
слишком: слишком
жетон: жетон
должный: должен должна
страна: страна страну страны
марка: марок
разбираться: разбирается разбираюсь
завершать: завершает завершающие
офицерский: офицерский
дополнительный: дополнительные
заместитель: заместитель
чудотворец: чудотворец
аниматрица: аниматрица
полярный: полярной
классический: классическая классической классическую
участвовать: участвуют
интересоваться: интересуется
начинаться: начинается начиналось
гнев: гнева
издательство: издательством
атака: атаки
бурный: бурным
срок: срок сроков
фантастический: фантастической
решительный: решительными
руководствоваться: руководствуются руководствующийся
первый: первая первого первое первой первые первый первым первых
звучать: звучат звучать
пространство: пространства пространство
выделить: выделил
большой: большое
возможность: возможностей возможности
кинокультура: кинокультуры
август: августа августе
образ: образом
помогать: помогал
казнить: казнены казнить
субтитр: субтитры
отличный: отличное
средний: средней средняя
фамилия: фамилии фамилия
распространяться: распространялись
способ: способы
командующий: командующим
выкуп: выкуп
войти: войти вошли
приказывать: приказывают
миттермайер: миттермайер миттермайера миттермайером
обучение: обучения
солдат: солдат солдатами солдатом
традиционный: традиционными
нарисовать: нарисован
продажа: продажа продажу
райнхард: райнхард райнхарда райнхарде райнхардом райнхарду
осудить: осуждён
распустить: распустил
чуждый: чужды
комма: комм
сражаться: сражается сражаться сражаясь
юем: юем
мстить: мстить
последователь: последователи
студия: студии студию студия
лишь: лишь
существовать: существовали существует
назначить: назначен
планироваться: планируется
публиковаться: публиковалась публикуется
уцелеть: уцелел
минута: минут
внешний: внешние внешний
далёкий: дальше далёкого далёкое далёком подальше
всё: всё
комбинезон: комбинезоны
банда: банды
мацумото: мацумото
инструмент: инструмента инструменты
стиль: стиле стиль
мицусэ: мицусэ
покориться: покорится
калейдоскоп: калейдоскоп
скоротать: скоротать
страница: страница странице страницу страницы
главный: главной главную главный главным главных
лексика: лексики
предубеждение: предубеждения
адриана: адриана
добавляться: добавлялись
неподвижный: неподвижной
боевой: боевая боевого боевым боевых
библиографический: библиографических
влюбить: влюблён
государственный: государственными
развитие: развитием развитии развития
иной: ином
кадзумить: кадзуми
самоустраниться: самоустранился
мудрый: мудрыми
ограбить: ограбить
сериал: сериал сериала сериале сериалом сериалу
фредерик: фредерика фредерике
подвергнуться: подверглось
страдать: страдал страдали страдают
один: одним одного одной одну
коронация: коронации коронация
стратегия: стратегии стратегия
решить: решил решили
император: император императора
опера: опер опера оперой оперы
англоязычный: англоязычном
возраст: возрасте
покидать: покидают
режим: режим режиме
постановка: постановки
постепенно: постепенно
процесс: процесс процессе
тогдашний: тогдашнего
дух: духу
триган: триган
выиграть: выиграл
сколько: сколько
девушка: девушек девушки
зарисовка: зарисовки
янагава: янагава
добродушный: добродушный
сплав: сплав
исследуться: исследуется
ёсико: ёсико
усилие: усилия
беглец: беглецы
кайзер: кайзер кайзера кайзере кайзером кайзеру
эдо: эдо
гигантский: гигантские
юлиан: юлиан юлиана юлианом юлиану
лентикулярный: лентикулярных
такэся: такэси
окко: окко
продолжение: продолжение
неправильный: неправильная
спектакль: спектакль
заинтересовать: заинтересует
тыс: тыс
разбойник: разбойники
план: план плане
стоить: стоил стоит
двор: дворе
визуальный: визуальной
сектант: сектантами
муж: мужа
воплощение: воплощении
фантазия: фантазия
араб: арабов
отправление: отправлениями
снять: снял сняты
странный: странное странный
ресурс: ресурсы
троецарствие: троецарствие
отправить: отправлен
трудно: трудно
месть: мести
умеренный: умеренного
шляпа: шляпе
население: населения
распространение: распространении
сильверберг: сильверберга
резиденция: резиденцию
бой: боя
разворачиваться: разворачивается
глубокий: глубоком
собрать: собрал
душа: душе душу
мятеж: мятеж
международный: международный
пристальный: пристального
рано: рано
сад: садом
доверять: доверять
усыновить: усыновил
никакой: никакого никакой
хирось: хироси
одарённый: одарённый
статистика: статистика статистикой
смочь: смог смогли сможете
деньга: денег
узнать: узнав
аристократ: аристократ аристократами
жанр: жанр жанре
оборотень: оборотни
поговорить: поговорить
возрасти: возросло
связаться: свяжитесь
вермилион: вермилионе
сценический: сценические
понести: понеся понёс
вывезти: вывезен
сэйун: сэйун
поставить: поставил поставлено
проницательность: проницательность
китайский: китайская
империализм: империализма
противоположность: противоположность
множество: множество
перерыв: перерыве
киёсить: киёси
хайнессена: хайнессене
природа: природу
правило: правилам
течение: течение
ян: ян яна яне яном яну
иов: иов
публикация: публикации публикация
идеальный: идеальна идеальной идеальным
выпивать: выпивать
минор: минору
форма: формы
менее: менее
родственник: родственниками
балл: баллов
предпочитать: предпочитает
взрывной: взрывных
граф: графа
правление: правлением правлению правления
конев: конев
далеко: далеко
принадлежащий: принадлежащая
рядовой: рядовых
ознакомиться: ознакомиться
попытаться: попытаться
неясно: неясно
оформление: оформление
гейдрих: гейдрихом
отсутствие: отсутствие
харлока: харлока
эпоха: эпохи эпоху
октябрь: октября
занять: занял
кэнъить: кэнъити
использоваться: использовалась
враг: врагов врагу
алкоголь: алкоголю
сопровождение: сопровождение
получить: полученного получил получили получить
германия: германии
разрушить: разрушен
разделение: разделения
свергнуть: свергнуть
известно: известно
стоимость: стоимостью
стартовать: стартовала
скучный: скучный
довольно: довольно
командир: командир командира
красавец: красавец
банкир: банкиров
потребоваться: потребуется
вступительный: вступительных
удобство: удобства
гражданский: гражданскую
чи: чи
родитель: родителей
наложить: наложили
шокировать: шокирующих
воскресение: воскресенье
резко: резко
список: списке список
принцип: принцип принципа
безопасный: безопасного безопасном
мюзель: мюзелей мюзель мюзелю мюзеля
лицо: лиц
освоить: освоило
превосходный: превосходные
поручить: поручив
художественный: художественная художественный
потрясти: потрясён
жемчужина: жемчужиной
организация: организацией организации организацию
назад: назад
совет: совета советами
сян: сян
слеза: слёзы
рецензент: рецензент
тысяча: тысяч тысячами тысячи
де: де
вампир: вампир
пацифист: пацифист
пролог: пролог прологом
оспаривать: оспаривает
установить: установлен
удаваться: удаётся
вселенная: вселенная вселенной вселенную
смысл: смысл смысле
существование: существование существования
иэяс: иэясу
использование: использование использования
инаб: инаба
продавать: продаваемого продавать
радиоэлектронный: радиоэлектронной
немецкий: немецких немецком немецкую
разработать: разработала
грязный: грязные
находиться: находилась находились находился находится находясь находящиеся
рыцарь: рыцарь
массасоить: массасоит
президент: президент президента президентом президенты
опенинга: опенинг
азия: азии
наказание: наказания
ураганный: ураганный
пять: пяти пять
путин: путин путиным
десятилетие: десятилетия
спрашивать: спрашивают
отредактировать: отредактирована отредактированные
апартеид: апартеида
календарь: календарю
избавляться: избавляется
угодный: угодно
властвовать: властвуй
заниматься: занимается
ссылка: ссылка ссылки
непобедимый: непобедимые
экранизация: экранизации экранизаций экранизация
эффектный: эффектны
свадьба: свадьба
пасть: пали
якобы: якобы
хорь: хори
манускрипт: манускрипт
кощунственный: кощунственным
шедевр: шедевры
историк: историка историки
ройенталь: ройенталем ройенталь ройенталя
компания: компанией компании
исток: истокам
лицензия: лицензии лицензию
брауншвайг: брауншвайга
ода: одой оды
самоубийство: самоубийство
плакат: плакатов
пьяный: пьяный
глобальный: глобальный
студент: студентом
римский: римской
малолетний: малолетнем
раздирать: раздирают
девочка: девочек девочка
гольденбаум: гольденбаум гольденбаумов
масако: масако
предыстория: предысторией предыстория
монета: монет монеты
юлий: юлий
монгол: монголов
связываться: связывалась
весь: весь всему вся
вольфганг: вольфганг вольфганга вольфгангом
аргумент: аргументы
фурукава: фурукавой
херварт: херварт
впервые: впервые
длительный: длительная
государство: государств государства
трансформер: трансформеров
иллюстратор: иллюстратор
брукнера: брукнера
подлежать: подлежали
армия: армии армия
стратегический: стратегических
тираж: тиражом
помощник: помощник
ошибка: ошибке
особый: особого
лагуна: лагуны
рынок: рынке
передаваться: передаётся
барак: барака
арицунэ: арицунэ
войско: войск войсками войсках
вопрос: вопроса
немногое: немногим
счёт: счёт
заявить: заявив
показываться: показываются
приходить: приходит приходить
помимо: помимо
тихо: тихо
тело: тела
соколиный: соколиного
заметить: заметите заметить
сопротивление: сопротивление сопротивления
платформа: платформах
вступление: вступления
добро: добра добро
одноимённый: одноимённой
достойный: достойная
полиция: полиция
характер: характер характером характеру
спиться: спившимся
измениться: изменились
жить: жить
овца: овца
музыка: музыка музыки музыку
качество: качества качестве
безусловно: безусловно
печать: печати
отменить: отменил
зять: зять
прочий: прочие
терять: теряют
династия: династии династию
ханадзав: ханадзава
напомнить: напомнить
кадзухико: кадзухико
цру: цру
просуществовать: просуществовал
мотив: мотивы
наглый: наглого
рю: рю
высота: высоте высоты
учёт: учёта учётом
переосмысливать: переосмысливает
карточка: карточек
тода: тода
кроме: кроме
частично: частично
надежда: надеждами
кабинет: кабинетов
си: си
проблема: проблем проблемам проблемой проблемы
разбой: разбоем
фудзисак: фудзисаки
фестиваль: фестиваля
издать: издано издать
пауль: пауль
работать: работавшего
эпопея: эпопея
запоминаться: запоминающимся запоминающихся
читатель: читатели
симпатичный: симпатичных
хиронака: хиронака хиронакой
требовать: требуют требуя
увлекательный: увлекательными
выйти: вышло
выгода: выгоду
нововведение: нововведений
реквием: реквием
обмен: обмен
бейблэйд: бейблэйд
дочь: дочери дочерью дочь
пытаться: пытаются
представляться: представлялось
уйти: уйти ушёл
ран: ран
фрагментарный: фрагментарные
заболевание: заболеванием заболеваниями
королевство: королевства
выступить: выступил
наследный: наследный
сбежать: сбежать
звание: звание званию
думать: думает думал думаю
конец: конца конце
июль: июля
дзиннать: дзиннай
абсолютный: абсолютная абсолютной
разжигать: разжигавший
предварительный: предварительным
интервью: интервью
каторжник: каторжником
крепость: крепостей крепости крепость
выдать: выдав
гайерсбург: гайерсбург гайерсбурга
пройти: прошло
вплоть: вплоть
потерять: потерял
досмотреть: досмотреть
авторский: авторскими
знаменитый: знаменитый
норио: норио
мера: мере
ограничиваться: ограничивалось
галактика: галактике галактики галактику
капитан: капитан капитана
двигать: движет
название: названий
актёр: актёр актёры
просмотр: просмотры
костюм: костюмы
оправдывать: оправдывает оправдывали
линия: линии
флот: флота флотом
хелен: хелен
звук: звук звуком
возлагать: возлагает
легенда: легенда легенде легенду
болтечь: болтек
широко: широко
летать: летающие
нужно: нужно
итог: итогам итоге
сокрушительный: сокрушительное
включать: включал
крайне: крайне
почитать: почитают
излюбить: излюбленным
проработка: проработке
лестница: лестнице
епископ: епископ
суметь: сумевшим сумели
кино: кино
диктатор: диктатор диктатором диктатору
внутренний: внутренней внутренним
крыло: крылья
идеал: идеалами идеалов идеалы
искать: искал искать
элемент: элемент
разгром: разгрома
молча: молча
мультфильм: мультфильмы
причина: причиной
махинация: махинации махинация
приставка: приставку
приход: прихода
контактировать: контактировал
средство: средства средством
читать: читать
схватить: схвачен
вспомнить: вспомнить
неприемлемый: неприемлемы
крещение: крещения
фурор: фурор
нацист: нацисты
прилежный: прилежным
ансбах: ансбаха
аристократия: аристократия
симпатизировать: симпатизирует
фанатский: фанатскими
оружие: оружие оружия
часть: часть частях
шесть: шести
увлекаться: увлекался увлекающихся
исидзук: исидзука
зритель: зрителей
тихий: тихая
трернихта: трернихта
отношение: отношению отношения
интригующий: интригующими
произнести: произнёс
эдуард: эдуарда
инвалид: инвалиды
саундтрек: саундтрек саундтреком
энциклопедия: энциклопедии
портал: портала
прежде: прежде
одиночка: одиночки
штауффен: штауффен
соратник: соратник соратники соратников
тоётомь: тоётоми
рисковать: рискует
восстание: восстание восстаний
цитировать: цитировать цитирует
серьёзность: серьёзности
объединить: объединить объединённую
взрослый: взрослых
кунемой: кунем
полёт: полёта
заслуживать: заслуживающие
жестокий: жестокий жестоким
классика: классики классикой
изображаться: изображается
союзник: союзник
писатель: писателя
недоброжелатель: недоброжелателей
среди: среди
негласный: негласное
трансляция: трансляцию
простолюдин: простолюдин
разговор: разговоре разговором
правитель: правителей правителем правитель
случайный: случайная
такаги: такаги
совершенно: совершенно
повод: поводом поводу
синий: синих
чувствовать: чувствовал чувствуем
фантастика: фантастика фантастики фантастикой
укрепить: укрепить
специальный: специального специальный
иронично: иронично
переложить: переложить
юхо: юхо
ранение: ранения
брюнхильда: брюнхильда брюнхильде
недостаток: недостатки недостаток
помощь: помощью
покинуть: покинуло покинуть
едва: едва
брукнер: брукнер
ланг: лангом
шостакович: шостакович
опьянить: опьянён
различный: различных
издатель: издатели издатель издателями
синъить: синъити
хитомь: хитоми
конфиденциальность: конфиденциальности
испытать: испытал
назвать: назвал
кот: кота
дата: дата
насилие: насилия
социальный: социальных
упрекать: упрекали
корпус: корпус корпусе
записывать: записывал
кинематографический: кинематографические
несколько: нескольких несколько
добровольно: добровольно
событие: событий события событиям
кирхайса: кирхайс кирхайса
заголовок: заголовком
научный: научная научной
похищение: похищения
однако: однако
площадь: площади
ситуация: ситуации ситуация
потеря: потерь потерю
задержание: задержание
бывать: бывает бывают
человечество: человечества человечество
исигуро: исигуро
советник: советник советником
положение: положение
гарм: гармов
наместник: наместника
число: числе число
лазердиск: лазердисках
посмертно: посмертно
тосио: тосио
требоваться: требуется
провозгласить: провозгласил
кройцер: кройцер
соревнование: соревнованием
остальной: остальные
сцена: сцен сцене
расстрелять: расстрелять
наполеон: наполеоном
очищение: очищением очищении
наиболее: наиболее
класс: классе
реальный: реальны
самообладание: самообладанием
поистине: поистине
рассказывать: рассказывающие
прошлое: прошлого
властный: властный
ненавидеть: ненавидит
величие: величие
сочувствовать: сочувствует
подковёрный: подковёрные
шаньхайгуанить: шаньхайгуань
обращение: обращения
терминатор: терминатор
персонаж: персонаж персонажами персонажах персонажей персонажи
тёмный: темный
жена: жена женой жены
спонсор: спонсоры
выше: выше
оскар: оскар оскара оскаром
кровавый: кровавого кровавыми
идеализировать: идеализирует
нобора: нобору
руководить: руководившим
карьерный: карьерной
родиться: родился
бокал: бокалом
кибергород: кибергород
восемь: восьмью
комаца: комацу
секта: сектой секты
окончательно: окончательно
элизабет: элизабет
популярность: популярности
указать: укажет указан
именно: именно
начальный: начальной начальные
наследник: наследников наследником
предание: преданием
удар: удар
апрель: апреля
том: тома томами томах томе томов
батальный: батальных
коллаборация: коллаборации
возникновение: возникновения
ромео: ромео
подниматься: поднимается поднимаются
роза: розы
приложение: приложением
зарабатывать: зарабатывают
благо: блага
предоставление: предоставления
необычайный: необычайные
устройство: устройств
помеха: помех
престол: престола
актуальность: актуальности
спланировать: спланированной спланированы
революционер: революционер
драма: драма
индивидуальный: индивидуальном индивидуальным индивидуальными
благодаря: благодаря
академия: академию
удерживать: удерживать
экземпляр: экземпляров
покупатель: покупателей
актёрский: актёрский
клон: клон
трагический: трагическая
сравнение: сравнению
конкретный: конкретным
безопасность: безопасности
след: след следов
гораздо: гораздо
сотрудничать: сотрудничал
императрица: императрице
служебный: служебные
сверхчеловек: сверхчеловека
пожаловаться: пожаловаться
нужный: нужны
условие: условий условия
плохой: плохим
вдохновить: вдохновила вдохновлена вдохновлён
табу: табу
журналист: журналистом
признаваться: признавались
владение: владениям
дворянин: дворян
выступать: выступает
стандартный: стандартные
эдвардс: эдвардс
демократия: демократии демократию демократия
избавиться: избавиться
англ: англ
визуально: визуально
действительно: действительно
ракета: ракет
македонский: македонский македонским
пыль: пыль
видеокассета: видеокассетах
друид: друид
верхушка: верхушки
доспех: доспехах
мёртвый: мёртв
закат: закат
пригодный: пригодной
голливудский: голливудских
эра: эры
адъютант: адъютант
результат: результат результате
зато: зато
томиям: томияма томиямы
женский: женские
незначительный: незначительной
канал: канале
знать: знать зная
март: марта
администрация: администрации
тактичность: тактичность
утверждать: утверждать
стоять: стоять
встретиться: встретиться
джо: джо
цезарь: цезарем цезарь
ориентация: ориентация
навигация: навигации навигация
олигархический: олигархический
оценка: оценку
положить: положено
мысль: мысли
соединить: соединил
самостоятельность: самостоятельностью
злой: злой
кацуметь: кацуми
мальчик: мальчиков
игра: игре игры
заглавный: заглавная
волшебный: волшебные
содержание: содержание
отдельность: отдельности
рекомендоваться: рекомендуется
катероза: катерозе
критика: критика
регент: регентом
удивительно: удивительно
подборка: подборка
посмотреть: посмотрел посмотреть
милый: милый
мина: мин
успех: успеха успехов
автор: автор автора
коммерческий: коммерческой
масштаб: масштабу
внедрить: внедрённых
школа: школа школы
сдерживать: сдерживавшего
обар: обара
талант: талантами
политик: политиков
контраст: контраст
теория: теория
герцог: герцога
имперец: имперцев имперцы
проиграть: проиграл
торговец: торговцем
хасимото: хасимото
жажда: жажда жажде
умереть: умер умереть
учиться: учился
байден: байдена
патетический: патетической
основа: основе
редкий: редким
лёгкий: легче
ненужный: ненужного
разделять: разделяй
формат: формат формате
сопрячь: сопряжённое
делать: делает делай делали
ценный: ценной
окружающий: окружающих
пожертвовать: пожертвовать
экспансия: экспансии
начальник: начальников начальником
больница: больнице
номер: номером
нерешительный: нерешительными
выбрать: выбрал выбран
разноцветный: разноцветные
вино: вина
ближний: ближнего
стремиться: стремятся
аспект: аспект аспекты
некоммерческий: некоммерческой
умерший: умершего
брут: брутом
изменить: изменил
судзумур: судзумура
коммандер: коммандер
психологический: психологических
интеллектуальный: интеллектуальные
идти: идут шло шёл
гравитация: гравитации
агент: агент
неделя: неделю
собака: собака
сновидение: сновидений
наложница: наложниц наложница наложницы
сложно: сложно
нейтральный: нейтральная
секретарь: секретарь
начаться: начался
тяжёлый: тяжёлые
теодор: теодора
бэтмена: бэтмен
чей: чьи
миллиард: миллиарда
писать: пишет
завоевать: завоевать
южноафриканский: южноафриканского
текущий: текущем текущие
обновить: обновлённые
библиотека: библиотеке
клеймо: клеймом
хидэёсить: хидэёси
он: нему нём
проявить: проявил
продумать: продуманная
делиться: делятся
дать: дал данная
копия: копий
тревога: тревоги
поклясться: поклясться
покорить: покорившая
рассказ: рассказов
иена: иен
товарищ: товарищ
поддерживать: поддерживает поддерживать
слово: словам слово
разрастись: разросшиеся
республиканец: республиканцев
доллар: долларов
кто: кого кому
род: рода родом
интерпретировать: интерпретируют
команда: команду
вновь: вновь
полагать: полагаю
бюджет: бюджета
править: править
мурая: мураи
простить: простить
отвратительный: отвратительные
зеро: зеро
возникать: возникающих
завершение: завершением завершения
чобить: чобиты
несчастный: несчастного
обсуждение: обсуждение
пользоваться: пользоваться
предать: предан преданная преданных
переходить: переходит
неважно: неважно
недостойный: недостоин
обращать: обращать
мирный: мирным мирных
наполеоновский: наполеоновские наполеоновских
года: годой
касаться: касается
знаток: знатоками
объективность: объективность
предназначить: предназначен предназначена
конный: конно
унсё: унсё
определённый: определённом
различие: различия
игнорировать: игнорирующие
согласно: согласно
модель: моделей
альтернатива: альтернативой
лихтенлад: лихтенладе
наименее: наименее
сигэра: сигэру
реакция: реакции
видео: видео
отстать: отстал
присвоить: присвоен
продвинуться: продвинулись
коммодор: коммодора
технология: технологии технология
неразумный: неразумных
чайковский: чайковский
сохраняться: сохранялось
уровень: уровне
игрушка: игрушек
диск: диск диски
черта: черта
сунсин: сунсина
долгий: дольше
пережиток: пережиток
продаваться: продавались
древность: древности
несомненно: несомненно
хотя: хотя
большинство: большинство большинству
гринхилла: гринхилл
обладать: обладает
прекрасный: прекрасная прекрасные прекрасный
спасти: спас спасти спасён
понятный: понятна
баталист: баталиста
мягкий: мягкое
бессмысленность: бессмысленность
тахара: тахара
горец: горец
оставить: оставив
потерпеть: потерпела
униформа: униформа
земной: земного
намереваться: намеревался
домашний: домашней
сюда: сюда
товарный: товарный
опыт: опыт
лю: лю
каванака: каванака
потомственный: потомственный
солдатский: солдатские
оригинал: оригинала
вклад: вклад
видеть: видели видит
побочный: побочные
чай: чай
масато: масато
противоположный: противоположным
встреча: встреча встречи
повторение: повторения
гибель: гибели гибель
беовульф: беовульф
выпускаться: выпускалось выпускаются
воспоминание: воспоминания
хасэгава: хасэгава
чёрный: чёрной чёрный
выполнить: выполнено
очевидный: очевидный
должность: должность
английский: английский
преимущество: преимущества
остаться: осталось
сак: сака
блестяще: блестяще
хитрый: хитрый хитёр
некоторый: некоторое некоторые
достаточно: достаточно
тоёт: тоёта
кадзухиро: кадзухиро
приближённый: приближённых
вознаграждаться: вознаграждаются
изображение: изображение изображением
дева: дева
волнующий: волнующую
хадзам: хадзама
культура: культуры
правый: правая
обширный: обширный обширными
появляться: появлялись
анимаг: анимаг
легендарный: легендарное
молодость: молодости
включить: включил включить
убийца: убийц
турнир: турнир
композиция: композиции
зарегистрировать: зарегистрированный
дизайн: дизайн дизайне
серийный: серийным
потрясение: потрясение
исикава: исикава
реальность: реальности
невский: невский
сым: сыма
блокнот: блокнот
против: против
потратить: потратить
мужчина: мужчин
значимость: значимость
вневременный: вневременные
длительность: длительность
улисс: улисс
тиран: тирана
нести: нести
объяснение: объяснение
сразу: сразу
ясно: ясно
эгоистичный: эгоистичные
ранний: ранних
свежий: свежие
способный: способные
исторический: историческая исторические
углублённый: углублённой
шторм: шторма
покой: покой
поступить: поступил поступило
графика: графика
заумный: заумен
бремя: бремя
завершить: завершена
развивать: развивают
масатося: масатоси
минц: минц
стрельба: стрельбе
республиканский: республиканского республиканской
машина: машинах
полностью: полностью
перечислить: перечислены
убежище: убежище
интерес: интереса
послужить: послужить
болеро: болеро
семья: семьи
религия: религии
скептицизм: скептицизма
паранойя: паранойи
любитель: любителям
человеческий: человеческой
аристократический: аристократической
жених: жениха
паразит: паразитов
выпустить: выпустить выпущенный выпущено выпущены
смерть: смертей смерти смерть смертью
доля: долей
алюминиевый: алюминиевом
сотрудничество: сотрудничество
поглотить: поглощёнными
сталин: сталин
шпаргалка: шпаргалкой
искусство: искусствам
солнечный: солнечную
долг: долгов
просить: просит
канэтый: канэто
чувство: чувство
ирония: иронии
получиться: получилось
вдумчивый: вдумчивых
справедливо: справедливо
ванпанчмный: ванпанчмен
второе: второе
сохранять: сохраняя
опасный: опасное
цвета: цветами
хеллбой: хеллбой
разрушение: разрушения
месяц: месяц
распространить: распространено распространены
обратиться: обратился обратиться
разный: разные
кан: кана
каталог: каталогах
мариендорф: мариендорф
версия: версии версия
присоединить: присоединил
суетливый: суетливы
категория: категории
джонатан: джонатан
детализировать: детализированные
нобунагой: нобунагой
титул: титул
ненависть: ненависти
трюнихта: трюнихт
мероприятие: мероприятие
недочеловек: недолюдьми
помнить: помнят
коридор: коридор
масася: масаси
утешать: утешает
отдельный: отдельных
сердечный: сердечного
окружение: окружение
оправиться: оправившись
спастись: спастись
указание: указанием
воспитание: воспитания
макиавелли: макиавелли
рассматривать: рассматривает рассматривать
руководитель: руководителей
поведение: поведения
блестящий: блестящим блестящих
обращаться: обращался обращаться
астарт: астарте
робот: роботы
аим: аим
иммензея: иммензее
это: это
день: день
целое: целого целом
определяться: определяется
баллотироваться: баллотироваться
примечание: примечания
биттенфельд: биттенфельд
протяжение: протяжении
поднимать: поднимают
обречь: обречь обречённых
построить: построен построенном
антон: антон
погибнуть: погиб
малер: малера
неконституционно: неконституционно
коллизия: коллизии
заметный: заметному
феззать: феззан
кадзь: кадзи
шив: шиве
поэтому: поэтому
лабиринт: лабиринт
количество: количество количеством
описание: описание
авторство: авторства
необходимо: необходимо
устрашать: устрашающая
материал: материал
озвучивание: озвучивания
тада: тада
вести: вела
утомительный: утомительна
отдать: отдал
осада: осада
удержание: удержания
поискать: поискать
сюдо: сюдо
сюнсукэ: сюнсукэ
преданность: преданности
прекратить: прекратить
альтернативный: альтернативным
выдержать: выдержать
бесконечный: бесконечный
также: также
исполнение: исполнение исполнении
жилище: жилища
кг: кг
служба: службу
юкихиса: юкихиса
тип: тип
вечный: вечное
представиться: представились
особенно: особенно
воинственный: воинственными
режиссёр: режиссёр режиссёры
ноябрь: ноября
кайтый: кайто
подряд: подряд
интрига: интриги
видный: видна
повышение: повышении
текст: текст
кодекс: кодекс
иначе: иначе
ханадзоно: ханадзоно
фридрих: фридрих фридриха
сакура: сакура
форт: форта
добрый: добром
однажды: однажды
выигрышный: выигрышнее
хидэаки: хидэаки
сексуальный: сексуальными
эпос: эпос
актриса: актриса
андзай: андзаи
жертва: жертвами жертвы
чарт: чарте
предыдущий: предыдущую
болтовня: болтовнёй
вторжение: вторжения
океан: океан
россия: россии
показаться: показаться
кой: коим
сакё: сакё
влиять: влияет
жадный: жадный
час: часов
место: места месте место
превосходить: превосходит
премьерный: премьерный
премьера: премьера
спокойно: спокойно
кобаясь: кобаяси
прийти: пришёл
похождение: похождениями
сторонник: сторонник
нехватка: нехватки
заурядный: заурядным
трёхмерный: трёхмерное
заставка: заставок
плохо: плохо
великодушный: великодушный
вырождение: вырождению
юбилей: юбилеем юбилею
заселить: заселены
ожидание: ожидания
билл: билла
четыре: четыре
вид: вид
направление: направление
раскрываться: раскрывается
амбициозный: амбициозный
они: ими ними
перевод: переводами
тактика: тактик тактика тактике
застой: застоя
эндо: эндо
связь: связь
хождение: хождение
ограниченный: ограниченным
создание: создания
особенный: особенного
переноситься: переносится
детство: детства
показывать: показывают
атмосфера: атмосферой
удовлетворительный: удовлетворительных
красный: красная
браузерный: браузерная
сиодзав: сиодзава
десять: десять
ходзумить: ходзуми
смотреть: см смотрели смотреть
скульптура: скульптуру
ветхий: ветхого
отсутствовать: отсутствует
танец: танец
формировать: формируют
индия: индии
исчезнуть: исчезнет
свобода: свободами
просвещённый: просвещённый
опрос: опросу
многий: многих
спокойный: спокойная
путь: путь
объявить: объявлено
проходить: проходит
добиться: добился добиться
франшиза: франшизы
введение: введение
значительный: значительных
пожениться: пожениться
нравиться: нравилась
код: код
стратег: стратег
выживание: выживания
обстановка: обстановке
изд: изд
уследить: уследить
аннероза: аннерозе
происхождение: происхождению
образец: образцу
подверженный: подвержена
занятие: занятием
манга: манга манги
производство: производства
её: её
сказать: скажут сказал сказать
середина: середине
рим: рима
митир: митиру
клык: клыки
кэя: кэя
свергать: свергают
злокачественный: злокачественной
деятельный: деятельное
погибать: погибают
секунда: секунд
хайнессти: хайнессена
получать: получает
ремейк: ремейк ремейком
триглава: триглав
алфавит: алфавиту
синдром: синдром
морить: мори
принадлежать: принадлежит
сэйнэн: сэйнэн
столкновение: столкновение
дзюнъить: дзюнъити
исполнять: исполняют
двигаться: движутся
верховный: верховного
уходить: уходили
размеренность: размеренности
беженец: беженцев
биография: биография
китай: китае китая
национальный: национальных
пайеттой: пайеттой
холодный: холоднее холодным
волк: волк
право: правами
япония: японии
принести: принесут
ответственность: ответственности
казаться: кажется
обычный: обычных
покемон: покемон
радикальный: радикальную
полномочие: полномочий
вынудить: вынужден вынуждена
посвятить: посвящённый
почему: почему
уникальный: уникальная
естественно: естественно
ваш: вашего
проистекать: проистекают
былой: былое
многие: многие
космос: космоса
конфликт: конфликт конфликта
чин: чин
сообщить: сообщить
симфония: симфоний
избранный: избранные
жестокость: жестокости жестокость
ёкоям: ёкояма
лэйдзь: лэйдзи
хрупкий: хрупким
взрыв: взрывы
устаревший: устаревшие
твёрдо: твёрдо
приказать: приказал
пустой: пустым
практически: практически
мировоззрение: мировоззрения
жизненный: жизненный
продолжать: продолжает
твёрдый: твёрдым
сила: силам силами
дэнсэца: дэнсэцу
решать: решают
рубинский: рубинский рубинского
конечный: конечном
маккарти: маккарти
свободный: свободной свободных
дом: дом
цзиньпин: цзиньпином
безвестность: безвестности
кихатить: кихати
реклама: рекламы
вместе: вместе
авторитаризм: авторитаризма
тристан: тристан
хотеться: хотелось
сеанс: сеанса
неожиданный: неожиданные
ёсик: ёсики
продюсерский: продюсерские
сухой: сухого
телевидение: телевидению
парламент: парламент
следить: следить
изначально: изначально
вождь: вождя
премия: премии
тематика: тематика
кук: куки
сон: снами
темперамент: темпераментом
вполне: вполне
заполучить: заполучить
адаптация: адаптацией адаптацию адаптация
приносить: приносят
известность: известность
автомобиль: автомобили
йозеф: йозефа
взгляд: взгляд взглядом
дайсукэ: дайсукэ
признак: признак
запись: запись
токио: токио
единственно: единственно
почитаться: почитается
форум: форум
византия: византии
крёстный: крёстный
скорее: скорее
подчеркнуть: подчеркнул
оборона: обороны
мамор: мамору
заставлять: заставляют
босоногий: босоногий
женатый: женат
поскольку: поскольку
равель: равеля
агентство: агентством
популярный: популярен популярна
повлечь: повлекшем
заговор: заговору
брамс: брамс
анимегид: анимегид
викидать: викиданных
изобличение: изобличения
сша: сша
основное: основном
она: неё
валькирия: валькирий
нация: нации нация
юки: юки
принимать: принимал
недовольство: недовольство
викинг: викингов
касахара: касахара
состояться: состоялась
принять: принял
окамото: окамото
достижение: достижения достижениями
скачать: скачать
чёткий: чёткого
неосвоенный: неосвоенных
делегация: делегации
хироюк: хироюки
убеждённый: убеждённый
небо: небесах
частый: чаще
включая: включая
обучить: обучил
сведение: сведения
вырвать: вырвали
вилья: вилье
комментарий: комментарии
насколько: насколько
подоплёка: подоплёку
итак: итак
сувабэ: сувабэ
судьбоносный: судьбоносной судьбоносные
поклонник: поклонников
иллюстрировать: иллюстрировала
тема: темы
формально: формально
прелесть: прелесть
упаднический: упадническая
юить: юити
русый: рус
пережить: пережил
состоять: состоит состоявшего
представать: предстают
исключение: исключением
активно: активно
четвёртый: четвёртый
тайлор: тайлора
тэдзук: тэдзука
гинга: гинга
клеймор: клеймор
вершина: вершине
счастие: счастьем
фальшивый: фальшивыми
букет: букета
вспоминать: вспоминал
упадок: упадка
защита: защите
построение: построения
подлый: подлый
тёплый: тёплые
грилльпарцер: грилльпарцера
ребёнок: детей
тетрадь: тетрадь
положительный: положительные
наверху: наверху
концовка: концовок
точно: точно
маэда: маэда
признать: признал
сходство: сходство
поначалу: поначалу
любить: любил
сасак: сасаки
тюрьма: тюрьме
рабочий: рабочее
полуприквел: полуприквел
сетовать: сетовать
гиббон: гиббона
книга: книги
нодзома: нодзому
справка: справка
ввести: ввести
намеренный: намерен
усвоить: усвоят
уступить: уступил
стич: стич
невинность: невинность
дважды: дважды
колонист: колонистами
карин: карин
андрис: андриса
корыстолюбивый: корыстолюбивый
вернуть: вернуть
узнавать: узнаёт
давно: давно
официально: официально
лицевой: лицевой
ожидать: ожидал
альбом: альбомов
правящий: правящей
присущий: присуща
серебряный: серебряные
производственный: производственный
лоэнграмм: лоэнграммов лоэнграммом
наступать: наступают
издание: издание
тухачевский: тухачевского
иллюзия: иллюзия
охватить: охватить
клиент: клиентов
паприка: паприка
лян: лян
сложиться: сложилась
вряд: вряд
словно: словно
перевести: переведены
способствовать: способствовало
труд: труд
центр: центр
обожать: обожающих
провести: проведённому
промышленность: промышленности
общество: обществе
симидз: симидзу
кристалл: кристаллов
медленный: медленный
рядом: рядом
джессика: джессика
близкие: близким
фрг: фрг
вероятно: вероятно
яп: яп
изнутри: изнутри
сюжетный: сюжетные
гостиница: гостиница
культистый: культисты
переговоры: переговорах
выбирать: выбирает
коидэ: коидэ
урваша: урваши
сакакибар: сакакибара
борис: борис
оппозиция: оппозиции
прототип: прототип
поздравить: поздравили
добраться: добраться
токугава: токугавой
проект: проектах
кирхайс: кирхайсом
хосино: хосино
симао: симао
планировать: планировал
сомалиец: сомалийцев
официальный: официальный
единоличный: единоличному
геббельс: геббельс
иванов: иванов
выразительность: выразительности
общественный: общественное
часто: часто
прихоть: прихоти
одноклассник: одноклассник
ухаживать: ухаживает
выясниться: выяснилось
пора: пор
разработчик: разработчики
чрезвычайный: чрезвычайных
входить: входит
вакамото: вакамото
ненормативный: ненормативной
ключ: ключе
тысячелетие: тысячелетия
феликс: феликса
выявление: выявлением
лицензиат: лицензиаты
ослепнуть: ослеп
январь: января
статуя: статую
надгробный: надгробном
уверенность: уверенность
