войти: войти
татарча: татарча
пфаффенайм: пфаффенайм
мазво: мазво
данмарь: данмари
описание: описание
бергем: бергем
авторство: авторства
родёрн: родерн
куртавон: куртавон
бельмание: бельманьи
материал: материал
эдвиллер: эдвиллер
бантзенайм: бантзенайм
женщина: женщин женщины
шалампа: шалампе
киршберг: киршберг
поиск: поиск поиску
бывший: бывший
ссылка: ссылка ссылками ссылки
гильдвиллер: гильдвиллер
обюра: обюр
инструмент: инструменты
карспак: карспак
неактивный: неактивны неактивными неактивных
роппентсвиллер: роппентсвиллер
страница: страница странице страницу страницы
евро: евро
мюншуза: мюншуз
обращение: обращения
тип: тип
бюля: бюль
представиться: представились
вильденстный: вильденстен
оберморшвира: оберморшвир
ноябрь: ноября
домашний: домашнего домашних
вольферсдорф: вольферсдорф
текст: текст
трудоспособный: трудоспособного трудоспособных
дюрменак: дюрменак
кодекс: кодекс
юнавира: юнавир
умеренно: умеренно
риквира: риквир
кёстлак: кёстлак
оберморшвиллер: оберморшвиллер
эгисхайма: эгисхайм
вюнаём: вюнайм
рибовилле: рибовилле
викисклад: викисклад викискладе
осгойный: осгоен
юнгерсайм: юнгерсайм
медиафайл: медиафайлы
апрель: апреля
виттельсать: виттельсем
мюлуза: мюлуз
вальтенайм: вальтенайм
дюрленсдорф: дюрленсдорф
использовать: использующие
составить: составила
доход: доходов доходы
аженбак: аженбак
тенденция: тенденцией
примечание: примечание примечания
миттельвира: миттельвир
сондернак: сондернак
аммершвира: аммершвир
событие: события
аттеншвиллер: аттеншвиллер
регисайма: регисайм
пункт: пункты
случай: случаях
бальтзенайм: бальтзенайм
верентсуза: верентсуз
вёгтленсоффный: вёгтленсоффен
бергольц: бергольц
заполнить: заполнить
работать: работали
тан: тан
ильфюрт: ильфюрт
ардённый: арденны
статья: статьи статья
скрытый: скрытые
население: население населения
служебный: служебные
условие: условий условия
версия: версия
ваттвиллер: ваттвиллер
супрефектура: супрефектура
гоммерсдорф: гоммерсдорф
гемара: гемар
индекс: индекс
строть: стрют
нидерентсный: нидерентсен
место: местах
франция: франции франция
озенбак: озенбак
сиккерта: сиккерт
который: которые которых
округ: округ округа
бернвиллер: бернвиллер
гевенаттный: гевенаттен
ранспак: ранспак
ларжицена: ларжицен
перейти: перейти
атстат: атстат
кантон: кантон кантона
идентификатор: идентификаторы
либо: либо
риквиллер: риквиллер
связаться: свяжитесь
экен: экен
гюнсбак: гюнсбак
арценхайм: арценхайм
риспак: риспак
редерсдорф: редерсдорф
мейенаём: мейенайм
бальдерсайм: бальдерсайм
андольсать: андольсем
логелайм: логелайм
архивировать: архивировано
департамент: департамент департамента
рейн: рейн
фельдкирша: фельдкирш
роршвира: роршвир
гесвасера: гесвасер
хозяйство: хозяйств хозяйства
моосларг: моосларг
март: марта
фонд: фонд
активность: активности активность
этан: этан
мочь: могут
навигация: навигации навигация
оттмарсайм: оттмарсайм
пюльверсайм: пюльверсайм
состав: состав
манспак: манспак
год: год года годам году лет
причина: причин
проживать: проживали проживало
студент: студентами
октябрь: октября
заглавный: заглавная
этерен: этерен
содержание: содержание
сультсмат: сультсмат
февраль: февраля
учесть: учтена учтены
м: м
код: код
пфеттеруз: пфеттеруз
омбур: омбур
нёвиллер: нёвиллер
швобен: швобен
заменить: заменить
виттенемой: виттенем
широта: ш
эльбак: эльбак
балго: балго
окстат: окстат
гевенаём: гевенайм
моош: моош
жюнольц: жюнольц
намбсайма: намбсайм
этот: эта
герб: герб
виллер: виллер
юберстрас: юберстрас
дессенхейм: дессенхейм
фастат: фастат
налог: налогом
тюркать: тюркем
правка: правка правки
больвиллер: больвиллер
вогельгрюн: вогельгрюн
кольмар: кольмар
распределение: распределение
ридисема: ридисем
оберларг: оберларг
альткирша: альткирш
гражданин: граждан
фальквиллер: фальквиллер
кингерсайм: кингерсайм
алфавит: алфавиту
численность: численность
вольшвиллер: вольшвиллер
ребёнок: дети
эттеншлаг: эттеншлаг
буксвиллер: буксвиллер
тагольсайм: тагольсайм
льёвр: льевр
романие: романьи
русский: русский
пожертвовать: пожертвовать
лембак: лембак
этемба: этемб
фрелана: фрелан
язык: язык языках
эвиллер: эвиллер
некоммерческий: некоммерческой
мужчина: мужчин мужчины
активный: активными активных
вегшейд: вегшейд
каценталь: каценталь
губершвира: губершвир
миттлак: миттлак
лотарингий: лотарингия
сообщество: сообщество
заявление: заявление
лотенбак: лотенбак
тагсдорф: тагсдорф
бальшвиллер: бальшвиллер
плотность: плотность
ответственность: ответственности
риксайма: риксайм
энжерсема: энжерсем
српски: српски
персональный: персональные
директива: директива
бисайма: бисайм
отредактировать: отредактирована
молло: молло
география: география
система: системе
дитвиллер: дитвиллер
баллерсдорф: баллерсдорф
блотзаём: блотзайм
оберергайм: оберергайм
альтен: альтенах
нп: нп
человек: человек человека
населённый: населённые
вальдигофный: вальдигофен
сообщить: сообщить
зиллисайм: зиллисайм
юндсбак: юндсбак
пояс: пояс
избранный: избранные
википедия: википедии википедия
рембашзель: рембашзель
лабарош: лабарош
юршенаём: юршенайм
эгенаём: эгенайм
фризный: фризен
лицензия: лицензии
сила: силу
регион: регион регионе
префектура: префектура
бидерталый: бидертал
мальмерспак: мальмерспак
коммуна: коммуна коммуне коммуны
сосайма: сосайм
альгольсайм: альгольсайм
геспицена: геспицен
ещё: ещё
левонкура: левонкур
сультсерный: сультсерен
кроть: крют
жебсайма: жебсайм
бендорф: бендорф
бартенемой: бартенем
баттенаём: баттенайм
ниффера: ниффер
мёрнак: мёрнак
кембс: кембс
временной: временная временные
французский: французский
люттербак: люттербак
рюлисайма: рюлисайм
составлять: составляла
мюспак: мюспак
налогоплательщик: налогоплательщик налогоплательщика
лотенбакзель: лотенбакзель
иртсфельден: иртсфельден
цифровой: цифровые
фюльрен: фюльрен
раммерсмат: раммерсмат
диаграмма: диаграммы
бервиллер: бервиллер
вольфгантсный: вольфгантсен
роггенуза: роггенуз
стоссвира: стоссвир
венкель: венкель
править: править
блодельсайм: блодельсайм
действовать: действовать
подробный: подробнее
мертсный: мертсен
ирсенг: ирсенг
севено: севен
ошибка: ошибке
часовой: часовой
домохозяйство: домохозяйств
мецраля: мецраль
взрослый: взрослые
фр: фр
член: члены
лов: лов
статус: статус
юненг: юненг
люмшвиллер: люмшвиллер
обсуждение: обсуждение
кук: куки
кюнаём: кюнайм
ольтен: ольтен
последний: последние последний последняя
виттерсдорф: виттерсдорф
эзенг: эзенг
житель: жителей
участие: участие
бринкайма: бринкайм
мерксайма: мерксайм
верхний: верхний
ород: ород
занятость: занятость
каппелена: каппелен
запись: запись
форум: форум
возраст: возраста возрасту
административно: административно
вальбак: вальбак
стаффельфельден: стаффельфельден
показатель: показатели показатель
уффольтс: уффольтс
виккершвира: виккершвир
создать: создать
нохчийна: нохчийн
гайсуза: гайсуз
имя: имён
фольгенсбур: фольгенсбур
печать: печати
гебвиллер: гебвиллер
эндлинген: эндлинген
ильзак: ильзак
ирзбак: ирзбак
оберсаасайм: оберсаасайм
постоянный: постоянная
вендзеть: вендзенем
страна: страна
викидать: викиданных
уффайма: уффайм
пространство: пространства
фельдбак: фельдбак
частично: частично
знак: знак
получить: получить
вольгельсайм: вольгельсайм
товарный: товарный
сюда: сюда
скачать: скачать
карта: картами
бреттен: бреттен
вклад: вклад
эльзас: эльзас
сторккенсон: сторккенсон
лигсдорф: лигсдорф
трудовой: трудовая
один: одного
артмансвиллер: артмансвиллер
оршвира: оршвир
зиммербак: зиммербак
сведение: сведения
эмсбрюн: эмсбрюн
глава: глава
линталь: линталь
другой: другие других
српскохрватски: српскохрватски
юрбес: юрбес
медиана: медиана
входить: входила
экономика: экономика
нидерморшвира: нидерморшвир
бетлак: бетлак
линсдорф: линсдорф
облагать: облагаемые облагаемых
фислис: фислис
два: двух
оберентсный: оберентсен
ученик: учениками
веттольсайм: веттольсайм
кётсенг: кётсенг
гюндольсайм: гюндольсайм
зелленберг: зелленберг
усный: усен
мэр: мэр
внук: внуки
люсель: люсель
валайм: валайм
леман: леман
танненкирша: танненкирш
цитировать: цитировать
континентальный: континентальный
жеттинген: жеттинген
экономически: экономически
зарегистрировать: зарегистрированный
политика: политика
эшенсвиллер: эшенсвиллер
просмотр: просмотры
позапрошлый: позапрошлом
ильталь: ильталь
иссенаём: иссенайм
сентайм: сентайм
бебленхайм: бебленхайм
сюндоффный: сюндоффен
центр: центра
либсдорф: либсдорф
мюрбак: мюрбак
феллеринг: феллеринг
безработный: безработными
фрёнинген: фрёнинген
орба: орбе
абсема: абсем
шлирбак: шлирбак
зессинга: зессинг
сентябрь: сентября
фортшвира: фортшвир
серна: серне
город: города
свежий: свежие
смотреть: см
спекбак: спекбак
справка: справка
новый: новые
беттендорф: беттендорф
митсак: митсак
элемент: элемент
дюрренентзный: дюрренентзен
стабилизация: стабилизации
либенсвиллер: либенсвиллер
грюссенайм: грюссенайм
читать: читать
рантсвиллер: рантсвиллер
мы: нами
веккольсайм: веккольсайм
бютвиллер: бютвиллер
мание: маньи
франкен: франкен
упразднить: упразднённого
текущий: текущие
мюнтсенайм: мюнтсенайм
привести: приведены
феррет: феррет
флаксландный: флаксланден
климат: климата
семья: семьи
сирентс: сирентс
история: история
стенбак: стенбак
стеттен: стеттен
зиммерсайм: зиммерсайм
мобильный: мобильная
энциклопедия: энциклопедии
сондерсдорф: сондерсдорф
киффи: киффи
энсисема: энсисем
руффак: руффак
доступный: доступен
свойство: свойство
почтовый: почтовый
стерненбер: стерненбер
рененг: рененг
бергхольццель: бергхольццель
эмерсдорф: эмерсдорф
источник: источник
пол: полу
вассербур: вассербур
брюбак: брюбак
учётный: учётную
декрет: декрет
стенсульц: стенсульц
короткий: короткий
аппенвира: аппенвир
ильяэзерна: ильяэзерн
викимедиа: викимедиа
розть: розено
вентсвиллер: вентсвиллер
среди: среди
использование: использования
шампаня: шампань
площадь: площадь
случайный: случайная
эмлинген: эмлинген
категория: категории
родёрен: родерен
эльфранзкирша: эльфранзкирш
лето: летом
вестальтный: вестальтен
бишвира: бишвир
числиться: числились числилось
мюнвиллер: мюнвиллер
обербрюки: обербрюк
рюстенар: рюстенар
изображение: изображениями
отдельный: отдельных
остайм: остайм
высота: высота
редерсайма: редерсайм
кнёренга: кнёренг
отказ: отказ
проект: проектах
бюшвиллер: бюшвиллер
динамика: динамика
сохранение: сохранением
свободный: свободной
брешомон: брешомон
указание: указанием
бильцайма: бильцайм
официальный: официальный
конфиденциальность: конфиденциальности
фесенаём: фесенайм
связанный: связанные
дата: дата
люттереть: люттер
поведение: поведения
пенсионер: пенсионерами
одёрен: одерен
ландсера: ландсер
основной: основные
разработчик: разработчики
мюнстер: мюнстер
дополнительный: дополнительные
беннвира: беннвир
эглинген: эглинген
виденсольный: виденсолен
рюдербак: рюдербак
дифматтный: дифматтен
дать: данные
бизель: бизель
организация: организации
аспак: аспак
протяжение: протяжении
гальфенг: гальфенг
август: августа
нидерергайм: нидерергайм
ретсвиллер: ретсвиллер
лапутруа: лапутруа
доллерена: доллерен
берензвиллер: берензвиллер
статистика: статистика
