войти: войти вошли
визовый: визовые
купец: купец купцами купцы
швеция: швеция
италия: италия
двойной: двойного
катар: катар
описание: описание
авторство: авторства
цирк: цирк цирком
материал: материал
новый: новая новую новые
дания: дания
наладить: наладили
спыхальский: спыхальский
поиск: поиск поиску
изделие: изделия
избежание: избежании
ссылка: ссылка ссылками ссылки
институт: институт институты
инструмент: инструменты
германский: германский
малайзия: малайзия
посольство: посольства посольство
иран: иран ирана иране ираном
страница: страница странице страницу страницы
дело: дел делам
обращение: обращения
сирия: сирия
япония: япония
хорватия: хорватия
фрукт: фрукты
реакция: реакцию
другой: другие других другое
нигер: нигер
восточный: восточные восточный
министр: министров
передать: передал
таиланд: таиланд
азербайджан: азербайджан
экваториальный: экваториальная
швейцария: швейцария
кипр: кипр
представиться: представились
область: области
намибия: намибия
исландия: исландия
мозамбик: мозамбик
нидерланды: нидерланды
чехия: чехия
текст: текст
решить: решили
кодекс: кодекс
визит: визит визитов визиты
начало: начало
иранский: иранские иранского
бруней: бруней
польский: польская польские польскими польских польского польской польскому польскую
министерский: министерская
викисклад: викисклад викискладе
сумма: сумму
указать: указан
гватемала: гватемала
медиафайл: медиафайлы
произойти: произошла
апрель: апреля
вьетнам: вьетнам
ирак: ирак
рейх: рейх
черногория: черногория
куба: куба
кыргызстан: кыргызстан
малави: малави
председатель: председатель
ирландия: ирландия
налогообложение: налогообложения
ботсвана: ботсвана
событие: события
цар: цар
мавритания: мавритания
установить: установил
турция: турция
южный: южная южный
словения: словения
джибути: джибути
независимость: независимость
число: числе
случай: случаях
доминик: доминика
эстония: эстония
сомали: сомали
преобразовать: преобразован
тегеран: тегеран тегерана тегеране
аббас: аббас
частный: частных
конго: конго
договор: договор
юар: юар
выселить: выселены
таджикистан: таджикистан
процесс: процесс
охрана: охраны
россия: россия
статья: статьи статья
покинуть: покинули
барбадос: барбадос
венецианский: венецианский
шаг: шагом
международный: международная международные международных
скрытый: скрытые
чили: чили
служебный: служебные
бежать: бежали
условие: условий условия
германия: германия
версия: версия
четыре: четырех
индонезия: индонезия
статистика: статистика
тринидад: тринидад
франция: франция
отдельный: отдельная отдельных
фиджи: фиджи
соединить: соединённые
иракский: иракский
великобритания: великобританию великобритания
нигерия: нигерия
перейти: перейти
микронезия: микронезия
кирибати: кирибати
беларусь: беларусь
союз: союз союза
либо: либо
государство: государство
варшавский: варшавский
миллион: миллиона миллионов
казахстан: казахстан
герцеговина: герцеговина
принсипи: принсипи
консульство: консульство
война: войне войны
связаться: свяжитесь
страна: стран странами страны
второй: второй
зариф: зариф
зеландия: зеландию зеландия
вторжение: вторжение
литва: литва
греция: греция
подписать: подписали подписано
некоторый: некоторые
гаити: гаити
вануату: вануату
один: одной одном
архивировать: архивировано
февраль: феврале
встреча: встреча
грузия: грузия
март: марта
фонд: фонд
перу: перу
мочь: могут
доминиканский: доминиканская
торговля: торговле торговля
раздел: раздел
требование: требования
навигация: навигации навигация
негативный: негативную
сельскохозяйственный: сельскохозяйственная
украина: украина
гренадин: гренадины
лагерь: лагерь лагерях
португалия: португалия
судан: судан
европеец: европейцам
мид: мид
персия: персия
недружественный: недружественным
канада: канада
туркменистан: туркменистан
заглавный: заглавная
временный: временный
первый: первой
содержание: содержание
красный: красной
суринам: суринам
посол: послы
общий: общей
кения: кения
бахрейн: бахрейн
код: код
армия: армии
комитет: комитет
гондурас: гондурас
джавад: джавад
окончание: окончания
посполить: посполитой
финляндия: финляндия
инвестиция: инвестиций
выделить: выделена
друг: друг друга
камерун: камерун
европа: европа европу
австралия: австралию австралия
этот: эта
переселять: переселяли
польша: польша польше польшей польши польшу
парагвай: парагвай
фисташка: фисташки
часть: части
ливия: ливия
больница: больница
правка: правки
стекло: стекло
люксембург: люксембург
оман: оман
лидер: лидерами
ягеллончик: ягеллончику
совет: совета
лаос: лаос
босния: босния
сырой: сырая
гражданин: граждан граждане
год: года годах году
сенегал: сенегал
маврикий: маврикий
вишеградский: вишеградская
нефтепродукт: нефтепродукты
европейский: европейским
амир: амир
русский: русский
пожертвовать: пожертвовать
бутан: бутан
чадо: чад
палау: палау
медицинский: медицинское
узуна: узуна
израиль: израиль
беженец: беженцев беженцы
язык: язык языках
бангладеш: бангладеш
мексика: мексика
некоммерческий: некоммерческой
ямайка: ямайка
восстановить: восстановили
тунис: тунис
окружающий: окружающей
варшава: варшаве
сообщество: сообщество
заявление: заявление
соломонов: соломоновы
май: мае мая
ответственность: ответственности
контакт: контакты
саудовский: саудовская
разместить: размещены
персональный: персональные
австрия: австрия
бурунди: бурунди
отредактировать: отредактирована
пнр: пнр
ватикан: ватикан
система: системе
марокко: марокко
габон: габон
который: которые который
тот: тех
веймарский: веймарский
бытовой: бытовая
сухофрукты: сухофрукты
сообщить: сообщить
избранный: избранные
википедия: википедии википедия
хамас: хамас
перевозка: перевозках
амброджо: амброджо
ссср: ссср
железо: железо
лицензия: лицензии
шах: шаха
аргентина: аргентина
взаимный: взаимной
араб: араб
пруссия: пруссией
соглашение: соглашение соглашений соглашения
коморский: коморские
белиз: белиз
мьянма: мьянма
ещё: ещё
северный: северная
сейм: сейма
письмо: письмо
сингапур: сингапур
сложность: сложности
пакистан: пакистан
самоа: самоа
признать: признал признали
исламский: исламская
руанда: руанда
дальнейший: дальнейшего
доллар: долларов
непал: непал
вместе: вместе
узбекистан: узбекистан
америка: америка америки
папуа: папуа
ховейд: ховейда
оба: обеих
неопр: неопр
вновь: вновь
восток: востоку
азия: азия
править: править
контаринить: контарини
тобаго: тобаго
монако: монако
действовать: действовать
подробный: подробнее
ошибка: ошибке
пётр: пётр
палестина: палестина
составить: составил
мальта: мальта
либерия: либерия
обсуждение: обсуждение
кук: куки
революция: революция
тонга: тонга
сенат: сената
панама: панама
содержать: содержит
антигуа: антигуа
прибывать: прибывают
участие: участие
осуществиться: осуществились
треугольник: треугольник
гамбия: гамбия
название: названием
запись: запись
андорра: андорра
форум: форум
латвия: латвия
океания: океания
государственный: государственного государственный
создать: создав создать
пластмассовый: пластмассовые
мальдивы: мальдивы
ангола: ангола
имя: имён
иметь: имеет
остров: острова
печать: печати
султан: султана
постоянный: постоянная
аравия: аравия
африка: африка
мусавить: мусави
уровень: уровне
викидать: викиданных
йемен: йемен
советский: советский советского
андерс: андерса
дипломатический: дипломатические
сша: сша
основное: основном
пространство: пространства
приблизительно: приблизительно
колумбия: колумбия
шахиншах: шахиншах
тувалу: тувалу
сибирь: сибирь
август: августа августе
невис: невис
знак: знак
гвинея: гвинея
объём: объём
хасан: хасана
получить: получить
двусторонний: двусторонние двусторонних
совершить: совершил
абхазия: абхазия
сотрудничество: сотрудничестве
воздушный: воздушных
сюда: сюда
прерываться: прерывались
скачать: скачать
товарный: товарный
барбуда: барбуда
оригинал: оригинала
вклад: вклад
продукт: продукты
комиссия: комиссия
австрийский: австрийской
остаться: остаться
сведение: сведения
бельгия: бельгия
мариан: мариан
камбоджа: камбоджа
глава: глава
замбия: замбия
торговый: торговые
бенин: бенин
итог: итоги
науру: науру
дорожный: дорожном
июнь: июня
сербский: сербская
известный: известный
два: двух
уругвай: уругвай
тайвань: тайвань
сербия: сербия
миллер: миллер
положить: положило
вызвать: вызвавшая
антииранский: антииранский
мировой: мировой
иностранный: иностранным
цитировать: цитировать
осетия: осетия
товарооборот: товарооборота
группа: группа
защита: защите
зарегистрировать: зарегистрированный
местный: местными
политика: политика
нефть: нефть
корея: корея
просмотр: просмотры
речь: речи
сальвадор: сальвадор
уганда: уганда
организовать: организованная
мохаммед: мохаммед
питание: питания
реза: реза
болгария: болгария
венесуэла: венесуэла
житель: жителями
сторона: стороны
сентябрь: сентябре сентября
поляк: поляков
тимор: тимор
македония: македония
экспорт: экспорт
эфиопия: эфиопия
гана: гана
свежий: свежие
смотреть: см
гренада: гренада
калининградский: калининградский
справка: справка
столица: столицах
монголия: монголия
обрести: обрела
венгрия: венгрия
элемент: элемент
высокий: высоком
оаэ: оаэ
читать: читать
мы: нами
египет: египет
текущий: текущие
гайана: гайана
семья: семьи
республика: республика республику
казимир: казимиру
осуществить: осуществил
история: история
время: время
открыть: открыла открыли
сообщение: сообщении
около: около
норвегия: норвегия
отношение: отношения
мобильный: мобильная
конференция: конференции
техника: техника
зимбабве: зимбабве
караван: караваны
словакия: словакия
энциклопедия: энциклопедии
среда: среды
китай: китай
испания: испания
эквадор: эквадор
доступный: доступен
лихтенштейн: лихтенштейн
албания: албания
кндр: кндр
демократический: демократическая
источник: источник
учётный: учётную
ближний: ближнему
молдова: молдова
сталь: сталь
виноград: виноград
армения: армения
короткий: короткий
викимедиа: викимедиа
прибыль: прибыли
переселение: переселения
поддержка: поддержке
использование: использования
пехлеви: пехлеви
оборудование: оборудование
случайный: случайная
сад: садов
румыния: румыния
сушёный: сушеный
эсватиня: эсватини
индия: индия
боливия: боливия
ивуар: ивуар
представительство: представительства
курдистан: курдистан
категория: категории
ковёр: ковры
лесото: лесото
никарагуа: никарагуа
бразилия: бразилия
багамы: багамы
помощь: помощью
сейшелы: сейшелы
лешек: лешек
мали: мали
ожидать: ожидать
отказ: отказ
проект: проектах
сохранение: сохранением
свободный: свободной
указание: указанием
конфиденциальность: конфиденциальности
официальный: официальный
пройти: прошла
эритрея: эритрея
ливана: ливан
назвать: назвал
связанный: связанные
дата: дата
такой: такие
поведение: поведения
ярошевич: ярошевич
кувейт: кувейт
мадагаскар: мадагаскар
пора: пор
разработчик: разработчики
несколько: несколько
танзания: танзания
дополнительный: дополнительные
филиппина: филиппины
дружба: дружбе
алжир: алжир
король: королю
последний: последний
империя: империей
бсср: бсср
примечание: примечания
османский: османской
афганистан: афганистан
организация: организации
российский: российской
стать: стали
штат: штаты
иордания: иордания
третий: третий
поход: похода
январь: января
народный: народную
навсегда: навсегда
тебриз: тебризе
маршаллов: маршалловы
