мы: нами
король: королям
эсба: эсбе
предание: преданию преданиям
мир: мир
пустынник: пустынник пустынником
пётр: петр петра петру пётр
число: числе
аскетический: аскетическое
поход: поход похода походов походу
деятель: деятели
проповедовать: проповедует
алфавитуучастник: алфавитуучастники
обещать: обещал
турок: турками
антиохия: антиохией антиохии
беседа: беседы
статья: статьи
энциклопедия: энциклопедии
читатьправитьправить: читатьправитьправить
отразиться: отразилось
современник: современникам современники
таить: таил
положение: положением
итал: итал
правкиновое: правкиновые
путь: путь
свет: света
помощь: помощи помощью
крестоносец: крестоносцам крестоносцев крестоносцы
крестовый: крестового крестовый крестовых
ресурс: ресурсы
умолять: умолять
деятельность: деятельности
который: которого которое котором которому которую
перейти: перейти
августинский: августинский
примечание: примечания
стоять: стоял
признавать: признавали
страницасодержаниеизбрать: страницасодержаниеизбранные
свой: своим свой своё
опечалить: опечален
окружать: окружал
беглец: беглецов
успех: успехе
навигация: навигации навигация
сон: сне
октябрь: октябре
франция: франции франция
крепостной: крепостных
страница: страница страницы
доблесть: доблесть
кербогойя: кербогой
никто: никто
википедия: википедии википедия
карточка: карточки
статьятекущий: статьятекущие
год: года году
проповедник: проповедник проповедников
статьисообществофорумсправкасвежий: статьисообществофорумсправкасвежие
лата: лат
июль: июля
сделать: сделал
родиться: род родившиеся родился
печать: печати
христианский: христианский
первый: первого
земля: земли землю
тирский: тирский тирского
политика: политика
записьвойти: записьвойти
готфрид: готфрида
дополнительный: дополнительные
медиафайл: медиафайлы
народный: народных
посоветовать: посоветовал
влияние: влияния
прибыть: прибыв прибыл
лишить: лишили
отодвинуть: отодвинула
проницательный: проницательного
фонд: фонд
ополчение: ополчение ополчения
уничтожать: уничтожали
источник: источник источниками источников
всё: всё
поиск: поиск поиску
князь: князья князьям
генеалогия: генеалогия
содействие: содействие
страницуполучить: страницуполучить
удалиться: удалился
главный: главным
июляумерший: июляумершие
благословить: благословил
присягнуть: присягнуть
язык: языках
мул: мула
иерусалим: иерусалим иерусалима
божественный: божественную
алексей: алексея
вождь: вождей вождями
г: г
каталог: каталогах
просмотр: просмотры
двигатель: двигателем
годуперсоналия: годуперсоналии
так: т
основать: основал
ссылкасведение: ссылкасведения
бульонский: бульонского
оказаться: оказалась
приписываться: приписывалась
некрополистик: некрополистика
действовать: действовать
внешний: внешние
танкред: танкред
урбан: урбан урбану
отказ: отказ
событияпожертвовать: событияпожертвовать
мирить: мирить
религия: религия
целый: целой
военный: военным
брокгауз: брокгауза
приписывать: приписывают
рассмотреть: рассмотрены
рим: риме
время: время
ревностный: ревностное
указание: указанием
викисклад: викискладе
этот: эта этих этому
около: около
движение: движения
жестокий: жестоких
викимедиа: викимедиа
нищенствовать: нищенствующего
монастырь: монастырь
свободный: свободной
амьенский: амьенский
каталанский: каталанская
российский: российская
некоммерческий: некоммерческой
воззвание: воззвание
всякий: всяких
ярко: ярко
познакомиться: познакомившись
страна: страна страны
явиться: явился
венгрия: венгрии
подняться: поднялись
спаситель: спасителя
армия: армии армию
иметь: имея
божий: божьем
персональный: персональные
указать: указан
бедственный: бедственным
рост: роста
занятие: занятий
условие: условий условия
переговоры: переговоров
выслушать: выслушал
монах: монах монахом
заставить: заставил
легенда: легенда легенды
глубоко: глубоко
обыкновенный: обыкновенным
дар: дары
епископство: епископство
словарь: словари словарь
запад: запад запада
улаживать: улаживать
возникнуть: возникла
итальянец: итальянцам
азия: азию
авторство: авторства
гвиберт: гвиберт
правкипостоянный: правкипостоянная
материал: материал
дата: дата
параметроввикипедия: параметроввикипедия
половина: половину
другой: другие других
записать: записанным
февраль: февраля
отредактировать: отредактирована
пресвитер: пресвитер
ошибкекак: ошибкекак
еврейский: еврейские
льежский: льежское
небольшой: небольшого
разбить: разбили
лишённый: лишённого
рыцарь: рыцари
бедный: бедного
имя: именем имя имён
решиться: решился
литература: литература
масса: массы
готовность: готовность
старый: старая
необходимость: необходимость
библиографический: библиографических
представляться: представлялся
короткий: короткий
прославлять: прославлял
представиться: представились
эмир: эмиром
собрать: собрав собравшим
версия: версии версия
неоднозначный: неоднозначными
амьен: амьен амьене
учётный: учётную
покинуть: покинул
энциклопедический: энциклопедический
взволновать: взволновавшем
выдёргивать: выдёргивали
англ: англ
второй: второй
анна: анна
подробный: подробнее
разработчик: разработчики
направить: направить
знак: знак
уходить: уходили
отдельный: отдельных
призыв: призывом
место: место
использование: использования
сам: самого
обратиться: обратился обратиться
присоединиться: присоединился
христос: христа
палестина: палестину
немой: нем
аббат: аббат
норвежский: норвежская
онлайн: онлайн
одержимый: одержим
сбежать: сбежит
англичанин: англичанам
викискладэлемент: викискладэлемент
направиться: направился
иерусалимский: иерусалимским
альберт: альберта
ефрон: ефрона
умереть: умер
тот: той
вследствие: вследствие
жалкий: жалкого жалкую
бежать: бежали бежать
дело: дела
утверждение: утверждениями
эпоха: эпохи
сообщить: сообщить
верёвочный: верёвочных
юи: юи
патриарх: патриархом
указывать: указывает
знать: знали
кодистория: кодистория
связаться: свяжитесь
многий: многих
осадить: осаждены
власть: власть
сельджук: сельджуки
код: код
средство: средств
страницецитировать: страницецитировать
формирование: формирований
настоятель: настоятелем
толпа: толпами
статьяобсуждение: статьяобсуждение
постоянный: постоянные
выдвинуть: выдвинув
ещё: ещё
венгр: венгров венгры
святость: святость
настроение: настроение
амьенеумереть: амьенеумершие
нищий: нищих
викидать: викиданных
мочь: могут
русский: русский
враг: врагов
походакатолический: походакатолические
пикардия: пикардию
плачевный: плачевной
рождение: рождения
уверенность: уверенность
тарентский: тарентский
человек: людях человек
превозносить: превозносят
римский: римская римской
христианин: христиан
упоминаться: упоминается
день: дней
заглавный: заглавная
больший: большая
поведение: поведения
кук: куки
вильгельм: вильгельм вильгельма
борьба: борьбе
голяк: голяк
выразить: выразил
идея: идеей
статистика: статистика
верёвка: верёвках
идти: идти
голод: голод
шерсть: шерсть
увлечь: увлёкший
папа: папа папе папу
переправа: переправы
священный: священная
последний: последний
текст: текст
симон: симоном
воодушевление: воодушевлением
империя: империя
судьба: судьба
заявление: заявление
благодать: благодать
народ: народ народу
мобильный: мобильная
комнина: комнина
свободно: свободно
править: править
смерть: смерти
настать: настал
родина: родину
сюдасвязанный: сюдасвязанные
почин: почина
ответственность: ответственности
великий: великую
днейматериал: днейматериалы
взятие: взятия
говорить: говорил говорят
кодекс: кодекс
вино: вином
категория: категории
инструмент: инструменты
лес: леса
лишь: лишь
поймать: поймал
системеобсуждениевкладсоздать: системеобсуждениевкладсоздать
тип: тип
орден: ордена
церковь: церкви церковь
пройти: прошёл
стать: стал
план: план
излагать: излагают
многие: многие
аскет: аскет
чех: чехи
пилигрим: пилигрима
уметь: умел
лицензия: лицензии
монахискрыть: монахискрытые
пространство: пространства
циветота: циветота
наружность: наружность
освобождение: освобождение
хлеб: хлеба
страницыслужебный: страницыслужебные
ссылка: ссылки
гроб: гроба
призывать: призывая
клермона: клермон
удаться: удалось
распределить: распределён
конфиденциальность: конфиденциальности
проповедь: проповедь
верчелли: верчелли
есть: ел
смотреть: см
спускаться: спускались
годуродиться: годуродившиеся
католический: католическая
алфавитурелигиозный: алфавитурелигиозные
французский: французская
византийский: византийского
миниатюра: миниатюра
товарный: товарный
истребить: истреблено
зарегистрировать: зарегистрированный
оттуда: оттуда
весь: всей
быстрый: быстрого
несогласие: несогласия
геоцепочка: геоцепочками
ум: ума
болгарин: болгары
питаться: питаясь
стычка: стычки
болгария: болгарии
он: нём
посланник: посланнике
крестьянин: крестьян
статьислучайный: статьислучайная
рыба: рыбой
глава: главе
ножанский: ножанский
один: одного
известный: известен
вернуться: вернулся
ахенский: ахенского
север: севере
доступный: доступен
организация: организации организация
беспорядочность: беспорядочность
стена: стен
скачать: скачать
викиданныхвикипедия: викиданныхвикипедия
случай: случаях
многочисленный: многочисленную
приятно: приятно
господний: господня
предписать: предписал
самый: самых
проект: проектах
делать: делал
бродяга: бродяг
сохранение: сохранением
обнаруживать: обнаруживало
ободрить: ободрил
описание: описание
участие: участие
вальтер: вальтер
император: императора
вскоре: вскоре
приносить: приносил
общий: общая
святыня: святыню
погром: погромы
битва: битвы
