мы: нами
список: списка список
отказ: отказ
желательно: желательно
событияпожертвовать: событияпожертвовать
системеобсуждениевкладсоздать: системеобсуждениевкладсоздать
апрель: апреля
сообщить: сообщить
футбольный: футбольные футбольный футбольных
год: году
примечание: примечание
устранить: устранены
выступление: выступлений
лицензия: лицензии
кодистория: кодистория
связаться: свяжитесь
указание: указанием
первенство: первенстве
пространство: пространства
код: код
футбол: футболу
страницецитировать: страницецитировать
донецкий: донецкой
викимедиа: викимедиа
алфавит: алфавиту
страница: страница страницы
сайт: сайте
свободный: свободной
страницыслужебный: страницыслужебные
ссылка: ссылки
статья: статьи статью
энциклопедия: энциклопедии
читатьправитьправить: читатьправитьправить
некоммерческий: некоммерческой
статьяобсуждение: статьяобсуждение
удалить: удалите
актуализировать: актуализировать
этап: этап
ныне: ныне
обновить: обновить
ещё: ещё
соревнование: соревнований
конфиденциальность: конфиденциальности
правкиновое: правкиновые
обновлениявикипедия: обновлениявикипедия
смотреть: см
украина: украины
втораягруппа: втораягруппа
викидать: викиданных
персональный: персональные
клуб: клуб клуба клубов клубы
следующий: следующего
перейти: перейти
мочь: могут
п: п
русский: русский
условие: условий условия
страницасодержаниеизбрать: страницасодержаниеизбранные
м: м
также: также
навигация: навигации навигация
элемент: элемент
город: города
товарный: товарный
существованиефутбольный: существованиефутбольные
лига: лига
авторство: авторства
зарегистрировать: зарегистрированный
значение: значения
сняться: снялся
команда: команда
википедия: википедии википедия
её: её
заглавный: заглавная
материал: материал
статьятекущий: статьятекущие
правкипостоянный: правкипостоянная
статьисообществофорумсправкасвежий: статьисообществофорумсправкасвежие
поведение: поведения
кук: куки
другой: другие других
отредактировать: отредактирована
ошибкекак: ошибкекак
печать: печати
димитров: димитров
шаблон: шаблон шаблонами
политика: политика
чемпионат: чемпионат чемпионата чемпионатах
н: н
статьислучайный: статьислучайная
статистика: статистика
имя: имён
записьвойти: записьвойти
недостаток: недостатки недостатков
областимирноградскрыть: областимирноградскрытые
доступный: доступен
прекратить: прекратившие
исключить: исключите
мирнограда: мирноград
дополнительный: дополнительные
сезон: сезон сезоны
организация: организации
украинский: украинский
короткий: короткий
скачать: скачать
представиться: представились
последний: последний
случай: случаях
текст: текст
область: области
выступать: выступала
фонд: фонд
учётный: учётную
проект: проектах
этот: эта
заявление: заявление
поиск: поиск поиску
клисф: клисф
страницуполучить: страницуполучить
сохранение: сохранением
мобильный: мобильная
начало: началом
править: править
язык: языках
подробный: подробнее
разработчик: разработчики
знак: знак
описание: описание
сюдасвязанный: сюдасвязанные
отдельный: отдельных
участие: участие
уголёк: уголёк
место: место
использование: использования
ответственность: ответственности
термин: термина
исправление: исправления
просмотр: просмотры
финал: финала
кодекс: кодекс
версия: версия
существовать: существуют
проблема: проблемы
кубок: кубок
категория: категории
ссылкасведение: ссылкасведения
источник: источник
инструмент: инструменты
улучшение: улучшения
действовать: действовать
