мы: нами
отказ: отказ
событияпожертвовать: событияпожертвовать
системеобсуждениевкладсоздать: системеобсуждениевкладсоздать
россия: россии россия
тип: тип
применять: применяемого
радовка: радовка
район: района
нп: нп
карта: картами карты
русый: рус
разъездпро: разъездпро
нижний: нижний
населить: населённом населённый населённых
сообщить: сообщить
изображение: изображений
округаскрыть: округаскрытые
лицензия: лицензии
исайкино: исайкино
входить: входил
кодистория: кодистория
связаться: свяжитесь
указание: указанием
почтовый: почтовый
федеральный: федеральный
пространство: пространства
смещение: смещение
центр: центр центра
код: код
статья: статьи статья
покровка: покровка
страницецитировать: страницецитировать
авдеевка: авдеевка
округ: округ округа округе
весь: вся
викимедиа: викимедиа
николькин: николькино
страница: страница страницы
емантаево: емантаево
свободный: свободной
страницыслужебный: страницыслужебные
ссылка: ссылки
малый: малый
энциклопедия: энциклопедии
читатьправитьправить: читатьправитьправить
некоммерческий: некоммерческой
даниловка: даниловка
искра: искра
география: география
пункт: пункт пунктах пункте пункты
статьяобсуждение: статьяобсуждение
гавриловка: гавриловка
содержание: содержание
страна: страна
ещё: ещё
конфиденциальность: конфиденциальности
васькино: васькино
правкиновое: правкиновые
красный: красная
яковлёвка: яковлевка
абдрахмановый: абдрахманово
сурмета: сурмет
смотреть: см
разъездтирис: разъездтирис
состав: состав
викидать: викиданных
персональный: персональные
закон: закон
алфавитунаселить: алфавитунаселённые
перейти: перейти
окато: окато
широта: ш
нива: нива
русский: русский
абдулинский: абдулинский абдулинского абдулинском
мочь: могут
условие: условий условия
примечание: примечания
образование: образований
страницасодержаниеизбрать: страницасодержаниеизбранные
дополнить: дополнив
территория: территории
численность: численность
старый: старые
идентификатор: идентификаторы
расположить: расположен расположенных
навигация: навигации навигация
январь: января
элемент: элемент
петровка: петровка
перепись: перепись
население: население населения
помочь: помогите
город: города
цифровой: цифровые
товарный: товарный
авторство: авторства
зарегистрировать: зарегистрированный
значение: значения
городской: городского городской городском
новокуяповский: новокуяповского
лесной: лесной
википедия: википедии википедия
её: её
материал: материал
октмый: октмо
заготовка: заготовка
год: года
административный: административный
зерикл: зерикла
шалты: шалты
степановка: степановка
северный: северная
статьятекущий: статьятекущие
другой: другие других
статьисообществофорумсправкасвежий: статьисообществофорумсправкасвежие
поведение: поведения
всероссийский: всероссийская
кук: куки
отредактировать: отредактирована
относительно: относительно
ошибкекак: ошибкекак
исчисление: исчислении
печать: печати
человек: человека
часовой: часовой
алексеевка: алексеевка
савельевка: савельевка
индекс: индекс
первомайский: первомайский
артамоновка: артамоновка
верхний: верхний
политика: политика
последний: последний последняя
прошлый: прошлом
статьислучайный: статьислучайная
статистика: статистика
муниципальный: муниципальных
второй: вторая
имя: имён
чемизло: чемизла
записьвойти: записьвойти
курмый: курмей
история: история
доступный: доступен
новый: новый
дополнительный: дополнительные
разъезд: разъезд
россиивикипедия: россиивикипедия
область: области область
новотроевка: новотроевка
организация: организации
время: времени
сельсовет: сельсовета
зона: зоне
субъект: субъект
короткий: короткий
преобразование: преобразовании
скачать: скачать
новоякуповый: новоякупово
викиданныхвикипедия: викиданныхвикипедия
представиться: представились
зоровка: зоровка
случай: случаях
правкипостоянный: правкипостоянная
текст: текст
июнь: июня
пояс: пояс
чеганл: чеганлы
фонд: фонд
тирис: тирис
аркаевка: аркаевка
большой: большой
учётный: учётную
это: это
булатовка: булатовка
черёмушки: черёмушки
заглавный: заглавная
проект: проектах
этот: эта
баклановка: баклановка
размещение: размещение
поиск: поиск поиску
заявление: заявление
страницуполучить: страницуполучить
сохранение: сохранением
мобильный: мобильная
править: править
язык: языках
подробный: подробнее
федерация: федерации
разработчик: разработчики
знак: знак
статус: статус
описание: описание
оренбургский: оренбургская оренбургской
сюдасвязанный: сюдасвязанные
отдельный: отдельных
андреевка: андреевка
абдулино: абдулино
участие: участие
алфёровка: алфёровка
звезда: звезда
использование: использования
ответственность: ответственности
москваоренбургабдулино: москваоренбургабдулино
термин: термина
составлять: составляет
находиться: находится
недалеко: недалеко
васильевка: васильевка
просмотр: просмотры
кодекс: кодекс
версия: версия
егорьевка: егорьевка
первый: первая
годунезавершённый: годунезавершённые
существовать: существуют
артемьевка: артемьевка
венера: венера
захаркино: захаркино
населённый: населённые
категория: категории
ссылкасведение: ссылкасведения
источник: источник источниками
инструмент: инструменты
правка: правка
часть: части
действовать: действовать
