мы: нами
трансляциискрытый: трансляциискрытые
влюбить: влюблённым
главныхроль: главныхролях
брэдлить: брэдли
купер: купер
леди: леди
брат: братом
копировать: копируйте
давидович: давидович
устраиваться: устраивается
кинорежиссёровфильм: кинорежиссёровфильмы
годавикипедия: годавикипедия
одинокий: одинокий
статья: статье статьи
энциклопедия: энциклопедии
кинокомпания: кинокомпании
версияправитьправить: версияправитьправить
правкиновое: правкиновые
ход: ходы
ресурс: ресурсов ресурсы
перейти: перейти
примечание: примечания
страницасодержаниеизбрать: страницасодержаниеизбранные
дом: дом дома
комната: комната
выручка: выручку
фильм: фильмах фильме фильмов фильмы
навигация: навигации навигация
сара: сара сарой
элемент: элемент
страница: страница страницы
отличаться: отличаться
годакинокомедия: годакинокомедии
отобрать: отобранные
википедия: википедии википедия
режиссёр: режиссёр
статьятекущий: статьятекущие
год: год года
майк: майк
статьисообществофорумсправкасвежий: статьисообществофорумсправкасвежие
молодой: молодой
приключение: приключения
печать: печати
пенелопа: пенелопа
политика: политика
убийство: убийств
записьвойти: записьвойти
эпизод: эпизоды
авторсценарий: авторсценария
поттер: поттер
дополнительный: дополнительные
четверг: четвергам
произведение: произведениях
тематический: тематические
писать: пишите
каталог: каталог
кэймена: кэймен
паркер: паркер
фонд: фонд
поиск: поиск поиску
страницуполучить: страницуполучить
рэппа: рэпп
язык: язык языках
ньюберн: ньюберн
энтони: энтони
понять: поймёт
шаблон: шаблонами
баг: баг
крис: крис криса
отдалить: отдалённого
коламбусы: коламбус
просмотр: просмотры
грэйдон: грэйдон
привет: привет
хиллфильм: хиллфильмы
сюжетавикипедия: сюжетавикипедия
ссылкасведение: ссылкасведения
искусство: искусства
отправляться: отправляется
отель: отель
действовать: действовать
внешний: внешние
отказ: отказ
сам: сами
событияпожертвовать: событияпожертвовать
годателевизионный: годателевизионные
шоссе: шоссе
сюжетный: сюжетные
вайта: вайт
телефильм: телефильм
дэрил: дэрил дэрилом
проверка: проверки
сью: сью
миллер: миллер
пиксель: пиксели
старший: старшим
указание: указанием
дорожный: дорожных
рон: рон
роль: ролях
няняхмолодёжный: няняхмолодёжные
сердце: сердец
годафильм: годафильмы
фильмыдебютный: фильмыдебютные
вд: вд
викимедиа: викимедиа
тодуэла: тодуэл
читатьтекущий: читатьтекущая
свободный: свободной
сбежать: сбежавшая
чикаготелевизионный: чикаготелевизионные
месяц: месяцев
некоммерческий: некоммерческой
холмс: холмс
продюсер: продюсеры
школа: школа
брэд: брэд брэда брэдом
страна: страна стране
оператор: оператор
потеряться: потерявшийся
хроника: хроники
брутон: брутон
беннетт: беннетт
персональный: персональные
свой: своей
дистрибьютор: дистрибьюторы
условие: условий условия
полный: полного полное
бренд: бренда
рождественский: рождественские
даутфайра: даутфайр
сайт: сайты
богема: богема
январь: января
важный: важные
авторство: авторства
рождество: рождество
мочь: могут можете
няня: няни
её: её
правкипостоянный: правкипостоянная
материал: материал
заготовка: заготовка
отредактировать: отредактирована
работа: работу
ошибкекак: ошибкекак
элизабет: элизабет
имя: имён
спродюсировать: спродюсированные
короткий: короткий
представиться: представились
спецвыпуск: спецвыпуски
сюжет: сюжет сюжета
версия: версии версия
маленький: маленький
учётный: учётную
май: майа мая
это: это
подопечный: подопечной
этот: эта
перси: перси
сша: сша
англ: англ
кугэн: кугэн
значительно: значительно
подробный: подробнее
разработчик: разработчики
недостаток: недостатков
знак: знак
отдельный: отдельных
использование: использования
майкл: майкл
космомагия: космомагии
марсия: марсия
дебра: дебра деброй
вместе: вместе
кормилица: кормилица
мина: мин
молния: молний
пожалуйста: пожалуйста
сообщить: сообщить
концовка: концовку
алфавитунезавершить: алфавитунезавершённые
кодистория: кодистория
связаться: свяжитесь
участник: участниками
приходящий: приходящей
код: код
включая: включая
страницецитировать: страницецитировать
доусон: доусон
проверяться: проверялась
джордж: джордж
статьяобсуждение: статьяобсуждение
старшеклассница: старшеклассница
длительность: длительность
ещё: ещё
хилллинда: хилллинда
дэвид: дэвид
языкефильм: языкефильмы
викидать: викиданных
сон: снов
проверить: проверенной
русский: русский
дополнить: дополнив
английский: английский английском
человек: человек
помочь: помогите помочь
персонаж: персонаж
жанр: жанр
энн: энн
секрет: секретов
кинофильм: кинофильм
заглавный: заглавная
поведение: поведения
уитфорд: уитфорд
кук: куки
линч: линч
камень: камень
мультсериал: мультсериал
пилотный: пилотные
статистика: статистика
рик: рик
хороший: лучшая
сшакинокомедия: сшакинокомедии
винсент: винсент
кит: кит
куперсмит: куперсмит
последний: последний
текст: текст
сериал: сериал
описание: описание описания
коламбусарежиссёр: коламбусарежиссёр
заявление: заявление
онофрио: онофрио
сценарист: сценарист
бета: бет
мобильный: мобильная
править: править
сюдасвязанный: сюдасвязанные
опытный: опытными
далее: д
бригада: бригад
ответственность: ответственности
двухсотлетний: двухсотлетний
алфавитуфильм: алфавитуфильмы
кодекс: кодекс
категория: категории
похититель: похититель
инструмент: инструменты
лишь: лишь
системеобсуждениевкладсоздать: системеобсуждениевкладсоздать
балбес: балбесы
немо: немо
полноценный: полноценного
рок: рок
лицензия: лицензии
мачеха: мачеха
пространство: пространства
неудачник: неудачниками
симкинс: симкинс
страницыслужебный: страницыслужебные
ссылка: ссылки
философский: философский
шерлок: шерлок
конфиденциальность: конфиденциальности
дэн: дэн
смотреть: см
гарри: гарри
эплебаум: эплебаум
друг: другом
призрак: призрак
товарный: товарный
зарегистрировать: зарегистрированный
тайный: тайная
звонить: звонит
андерсон: андерсон
подруга: подруга
статьислучайный: статьислучайная
мелодия: мелодия
проект: проектах проекту
композитор: композитор
добавить: добавив
жизнь: жизнь
доступный: доступен
шу: шу
няниангл: няниангл
организация: организации
клуб: клуб
скачать: скачать
викиданныхвикипедия: викиданныхвикипедия
случай: случаях
актёр: актёр
пока: пока
документальный: документальный
обст: обст
сохранение: сохранением
джексон: джексон
лолита: лолита
канада: канада
текущий: текущая
ночь: ночь
миссис: миссис
участие: участие
другой: других
разбитый: разбитых
оригинал: оригинал
полнометражный: полнометражных
девять: девять
требовать: требует
гремлин: гремлины
снятой: снятые
бесстрашный: бесстрашный
источник: источник источниками
комедия: комедия
правка: правка
