войти: войти
этот: эта этому
волость: волости волость волостью волостями
чуметь: чуми
каксало: каксал
описание: описание
авторство: авторства
шомекей: шомекей
тубалар: тубалары
материал: материал
лишь: лишь
дуванейский: дуванейская дуванейской
поиск: поиск поиску
калмашбашево: калмашбашево
баганал: баганалы
дулата: дулаты
инструмент: инструменты
бадрака: бадрак
цзе: цзе
ковуя: ковуи
страница: страница странице страницу страницы
белые: белые
значительно: значительно
тюркют: тюркюты
территория: территории территорий
шект: шекты
киргиз: киргиз киргизы
тобыкт: тобыкты
ногаец: ногайцы
кувакан: кувакан
представиться: представились
кыпсак: кыпсак кыпсаки
катаган: катаганы
уваныш: уваныш
рапатовый: рапатово
жалайыр: жалайыры
ноябрь: ноября
текст: текст
кодекс: кодекс
асфандияр: асфандияров
казах: казахи
башкирский: башкирские башкирского
кайтагец: кайтагцы
еланец: еланцы
юртовца: юртовцы
ошакт: ошакты
кырка: кырки
тюрк: тюрки
вотчинный: вотчинной
монолдора: монолдоры
уран: уран
чуб: чуб
тангаура: тангаур тангауры
абак: абак
таракт: таракты
дуванеец: дуванейцы
кета: кете
гаоцзевать: гаоцзюй
использовать: использующие
алаш: алаша
майман: майманы
кубанский: кубанские
скрытый: скрытая
хыргысый: хыргысы
берендей: берендеи
племя: племена племя
событие: события
сибирский: сибирские сибирской
алтын: алтын
кыпчак: кыпчаки
баят: баяты
земля: земель земли
кият: кияты
случай: случаях
начальник: начальнику
джемшида: джемшиды
куандык: куандык
таныпский: таныпской
тора: торе
отличаться: отличаться
саитовый: саитово
дизайнполиграфсервис: дизайнполиграфсервис
запад: западе
народ: народа
статья: статьи статья
родовой: родовых
биря: бирь
служебный: служебные
катать: катай
ыст: ысты
дуло: дулу
версия: версии версия
условие: условий условия
группа: группа группой группы
найман: найманы
авар: авары
баяндыра: баяндыр
уфа: уфа
который: которыми
тама: тама
перейти: перейти
тюмена: тюмены
кантон: кантона
балыкса: балыксы
сынрять: сынрян
адай: адай
ашидэ: ашидэ
связаться: свяжитесь
кеево: кеево
черик: черики
добавить: добавить
гэрэ: гэрэ
правка: правки правок
барг: баргы
елана: елан
айдабол: айдабол
кумрука: кумрук
буджакский: буджакские
дурмена: дурмены
л: л
сесть: сел
состав: состав составе
фонд: фонд
конец: концу
мочь: могут
уаки: уаки
фуюйский: фуюйские
кошс: кошсы
навигация: навигации навигация
кундуйти: кундушли
хягас: хягасы
происхождение: происхождение происхождения
бакаево: бакаево
шато: шато
тофалар: тофалары
гирей: гирей
оразкелди: оразкелди
локаец: локайцы
заглавный: заглавная
волшебный: волшебные
первый: первой
содержание: содержание
этнический: этническая этнический этническое
носитель: носителей
аргын: аргыны
суаны: суаны
торткара: торткара
код: код
иранский: иранские
половина: половине
уна: ун
мина: мин
тазлара: тазлары
поселение: поселения
гуить: гуены
её: её
середина: середине
мурзалар: мурзалар
таз: таз
теленгит: теленгиты
гунн: гунны
сохраниться: сохранился
сяньби: сяньби
салъть: салъют
ирэкт: ирэкте
каршин: каршин
татарин: татары
кайрылман: кайрылманы
казахский: казахские
ихсаново: ихсаново
каратяк: каратяки
русский: русский
пожертвовать: пожертвовать
алшын: алшыны
русифицировать: русифицированной
уходить: уходили
монгольский: монгольский монгольского
мурзаларец: мурзаларцы
кес: кесе
язык: языках
некоммерческий: некоммерческой
азино: азино
кудея: кудей
басмылый: басмылы
атыгай: атыгай
нагайбак: нагайбаки
керей: кереи
толенгит: толенгиты
ёный: еней
сообщество: сообщество
заявление: заявление
север: севере
чараймак: чараймаки
канлинский: канлинскими
ответственность: ответственности
бур: бура
персональный: персональные
отредактировать: отредактирована
ельдяк: ельдяк
система: системе
сопредельный: сопредельных
спорный: спорно
проверка: проверки
ссылка: ссылка ссылки
межа: межи
минг: минг минги
есентемир: есентемир
сообщить: сообщить
избранный: избранные
википедия: википедии википедия
усунь: усуни
берш: берш
проверить: проверенной
лицензия: лицензии
костромской: костромские
кантонный: кантонному
век: века
конырата: коныраты
ойхор: ойхоры
ещё: ещё
следующий: следующие
кубаляк: кубаляки
юг: юге югу
секея: секеи
юэчж: юэчжи
байула: байулы
юрмить: юрми
китапа: китап
кушать: кушаны
калмак: калмак
сиргель: сиргели
район: район
жакаим: жакаим
сельджук: сельджуки
алхон: алхоны
править: править
тело: теле
действовать: действовать
дыуанай: дыуанай
подробный: подробнее
уар: уары
граничить: граничили
ошибка: ошибке
вкл: вкл
унларец: унларцы
кубоу: кубоу
терсякнуть: терсяк
шеркеш: шеркеш
обсуждение: обсуждение
кук: куки
каракеська: каракесек
маскар: маскар
исторический: исторические
размежевание: размежевании
участие: участие
башкир: башкир
кальтатай: кальтатаи
этнос: этносы
запись: запись
форум: форум
савира: савиры
белый: белой
байлара: байлар байлары
ергенект: ергенекты
старокалмашево: старокалмашево
буг: бугу
создать: создать
унгута: унгуты
кыргыз: кыргызы
имя: имён
хакас: хакасы
табынский: табынской
мусабазари: мусабазари
нижнебельский: нижнебельской
упить: упей
печать: печати
четверть: четверти
постоянный: постоянная
алты: алты
шум: шум
необщепринять: необщепринят
викидать: викиданных
осинский: осинской
карлук: карлуки
мангыть: мангыты
пространство: пространства
мавлютовый: мавлютово
тан: тана
минец: минцы
уйгур: уйгуры
кызылкурт: кызылкурт
байбакты: байбакты
знак: знак
огуза: огузы
башкортостан: башкортостана
усёргать: усерган
получить: получить
библиография: библиография
уранец: уранцы
динлина: динлины
доп: доп
товарный: товарный
сюда: сюда
скачать: скачать
год: года
растерять: растеряли
барын: барыны
чагатай: чагатаи
вклад: вклад
ысык: ысык
требовать: требуют
юрмат: юрматы
ак: ак
кузей: кузеев
опытный: опытными
каратай: каратай
десятина: десятину
сызг: сызгы
якут: якуты
роды: роды
дуваня: дуваней
сведение: сведения
танып: танып
чумугунь: чумугунь
албан: албаны
байталла: байталлы
тюрко: тюрко
другой: другие других
каршинец: каршинцы
остаться: осталось
калмаки: калмаки
хоро: хоро
расселение: расселение расселения
тургак: тургаки
долан: доланы
чуюэ: чуюэ
июнь: июня
название: название
сикый: сикым
юртовый: юртовым
подчиняться: подчинялись
являться: является
каракалпак: каракалпаки
кураминец: кураминцы
балта: балта
румынский: румынские
утара: утары
кимаки: кимаки
цитировать: цитировать
кереит: кереиты
иметь: имела
находиться: находились
сагайец: сагайцы
шегендык: шегендык
дорога: дороги
чубанить: чубань
зарегистрировать: зарегистрированный
политика: политика
сосед: соседями
дуванейцов: дуванейцов
просмотр: просмотры
вотчина: вотчинами
жаппас: жаппас
баш: баш
кун: куны
участник: участниками
тамьяна: тамьян
сальют: сальюты
свежий: свежие
река: реке реки
смотреть: см
дуван: дуван дуваны
уезд: уездах
суйка: суйек
краткий: краткая
крымский: крымские
справка: справка
новый: новые
проверяться: проверялась
элемент: элемент
канжыгала: канжыгалы
качинец: качинцы
эфталит: эфталиты
форма: формой
достигать: достигая
время: времени
новокалмашево: новокалмашево
читать: читать
сырза: сырзы
мы: нами
каршинский: каршинской
айле: айле
текущий: текущая текущие
хионит: хиониты
субить: суби
алимул: алимулы
суйиндык: суйиндык
история: история
юз: юзы
энциклопедия: энциклопедии энциклопедия
афшара: афшары
аблаево: аблаево
канл: канлы
мобильный: мобильная
бишуть: бишул
фирузкуха: фирузкухи
оттоман: оттоманы
тюркоязычный: тюркоязычные
лес: леса
ногай: ногаи
старшина: старшинам
доступный: доступен
могол: моголы
компонент: компонент
степной: степные
узбекский: узбекские
тувинец: тувинцы
документ: документ
расмекеево: расмекеево
источник: источник источниках
теймурь: теймури
сеяньто: сеяньто
жданко: жданко
чат: чаты
категория: категории категория
уйсуна: уйсуны
учётный: учётную
правобережный: правобережные
тесно: тесно
кундровца: кундровцы
деревня: деревень
короткий: короткий
дагестаноязычный: дагестаноязычные
кытая: кытаи
кунграт: кунграты
викимедиа: викимедиа
наука: наука
малый: малые
использование: использования
случайный: случайная
карасакать: карасакал
больший: большие
пока: пока
янгузин: янгузин
хунн: хунну
тамьян: тамьяны
табын: табын табыны
шанышкылый: шанышкылы
три: трёх
кайя: кайи
основной: основной
тобасец: тобасцы
бикатин: бикатин
юэбанить: юэбань
отдельный: отдельных
кидарита: кидариты
таймани: таймани
лобнорцы: лобнорцы
телеут: телеуты
отказ: отказ
проект: проектах
хазареец: хазарейцы
сохранение: сохранением
свободный: свободной
указание: указанием
конфиденциальность: конфиденциальности
телеу: телеу
связанный: связанные
буляр: буляр
поведение: поведения
карагаша: карагаши
разработчик: разработчики
связать: связана
гайн: гайна
несколько: несколько
узбек: узбеки
дополнительный: дополнительные
последний: последний
примечание: примечания
бурзян: бурзян
организация: организации
тёлёс: тёлёсы
каржас: каржас
памирский: памирские
шымыр: шымыр
статистика: статистика
