мы: нами
название: названия
отказ: отказ
событияпожертвовать: событияпожертвовать
системеобсуждениевкладсоздать: системеобсуждениевкладсоздать
россия: россии
колумбия: колумбия
стадион: стадион
сок: сок
баутиный: баутин
полигран: полигран
результат: результаты
футзал: футзала футзале футзалу
сообщить: сообщить
год: гг году
команда: команд
выступление: выступлений выступления выступлениями
конфедерация: конфедерации
лицензия: лицензии
кодистория: кодистория
связаться: свяжитесь
указание: указанием
основный: основная
испания: испания
пространство: пространства
виктор: виктор
код: код
футбол: футболу
страницецитировать: страницецитировать
викимедиа: викимедиа
аржаной: аржаных
владимир: владимир
страница: страница страницы
сезон: сезон сезоне
обладатель: обладателей обладатель
сайт: сайт сайте
кубок: кубка кубков кубок
свободный: свободной
страницыслужебный: страницыслужебные
официальный: официальный
президент: президент
суперкубок: суперкубка
ссылка: ссылки
гостевой: гостевая
энциклопедия: энциклопедии
читатьправитьправить: читатьправитьправить
некоммерческий: некоммерческой
статьяобсуждение: статьяобсуждение
высокий: высшая
трёхкратный: трёхкратный
россииспортивный: россииспортивные
ещё: ещё
конфиденциальность: конфиденциальности
международный: международного
чемпионат: чемпионат чемпионата чемпионатах чемпионате
правкиновое: правкиновые
пятикратный: пятикратный
основать: основан основанные
смотреть: см
викидать: викиданных
персональный: персональные
призёр: призёр
перейти: перейти
мочь: могут
русский: русский
условие: условий условия
прежний: прежние
бронзовый: бронзовый
страницасодержаниеизбрать: страницасодержаниеизбранные
москва: москва москвы
также: также
соревнование: соревнование
европейский: европейских
навигация: навигации навигация
элемент: элемент
чехия: чехия
клубный: клубных
октябрь: октября
товарный: товарный
первенство: первенств
лига: лига
авторство: авторства
зарегистрировать: зарегистрированный
уефс: уефс
википедия: википедии википедия
заглавный: заглавная
правкипостоянный: правкипостоянная
материал: материал
российский: российский
статьятекущий: статьятекущие
путать: путать
статьисообществофорумсправкасвежий: статьисообществофорумсправкасвежие
поведение: поведения
кук: куки
чемпион: чемпион чемпионов
принимать: принимал
отредактировать: отредактирована
ошибкекак: ошибкекак
ффр: ффр
печать: печати
добавить: добавить
политика: политика
статьислучайный: статьислучайная
статистика: статистика
имя: имён
записьвойти: записьвойти
доступный: доступен
дополнительный: дополнительные
организация: организации
серебряный: серебряный
зал: залах
клуб: клуб клуба клубы
короткий: короткий
скачать: скачать
представиться: представились
последний: последний
западный: западной
случай: случаях
помимо: помимо
текст: текст
футзальный: футзальный футзальных
фонд: фонд
учётный: учётную
проект: проектах
это: это
тренер: тренер
этот: эта
заявление: заявление
поиск: поиск поиску
страницуполучить: страницуполучить
сохранение: сохранением
мобильный: мобильная
править: править
язык: языках
федерация: федерации
форма: форма
подробный: подробнее
разработчик: разработчики
знак: знак
занятой: занятое
описание: описание
сюдасвязанный: сюдасвязанные
отдельный: отдельных
достижение: достижения
участие: участие
место: место
годуклуб: годуклубы
другой: других
использование: использования
ответственность: ответственности
четырёхкратный: четырёхкратный
главный: главный
среди: среди
мир: мира
г: г
просмотр: просмотры
кодекс: кодекс
версия: версия
первый: первая
категория: категории
ссылкасведение: ссылкасведения
источник: источник
инструмент: инструменты
занять: занял
действовать: действовать
