войти: войти
калныньша: калныньша
фортепианный: фортепианная
действовать: действовать
подробный: подробнее
хороший: лучших
ингус: ингусом
музыкант: музыкант музыканты
вит: вита
школа: школу школы
статья: статьи статья
ошибка: ошибке
описание: описание
авторство: авторства
преподавать: преподаёт
тромбонист: тромбонист тромбонистом
консерватория: консерватории консерваторию
материал: материал
вериня: вериня
латвийский: латвийская латвийский латвийских латвийского латвийской латвийскую
биография: биографии
заглавный: заглавная
болеслав: болеславом
виксон: виксне
содержание: содержание
поиск: поиск поиску
кавалер: кавалер кавалеры
племянник: племянник
правка: правка правки
обсуждение: обсуждение
кук: куки
учебный: учебных
радио: радио
свежий: свежие
звезда: звёзд
смотреть: см
код: код
пуриня: пуриня
последний: последний последняя
проект: проект проектах
инструмент: инструменты
оба: обоих
инк: инков
справка: справка
новый: новые
страница: страница странице страницу страницы
участие: участие
язык: язык языках
элемент: элемент
имя: имени имён
флейтистка: флейтисткой
обращение: обращения
условие: условий условия
жена: жена
рижский: рижского
читать: читать
запись: запись
первый: первая
музыкальный: музыкальная музыкальной музыкальную музыкальные музыкальный
тип: тип
википедия: википедии википедия
представиться: представились
сергей: сергеем
сын: сыновья
форум: форум
этот: эта
мы: нами
стажироваться: стажировался
янис: янисом
студия: студии
текущий: текущие
современник: современников
латвия: латвии
ноябрь: ноября
создать: создать
перельман: перельмана
вокалист: вокалистов
ученик: учеников
карточка: карточки
править: править
источник: источник источниками
текст: текст
кодекс: кодекс
пианист: пианист пианисты
государственный: государственную
музыка: музыка музыки
учиться: учился
кларнетист: кларнетист
история: история
печать: печати
нормундс: нормундс
копия: копия
постоянный: постоянная
детлава: детлава
исполнить: исполнил
указать: указан
мобильный: мобильная
викидать: викиданных
год: гг года году лет
алфавит: алфавиту
рига: рига риге
язеп: язепа
зилбертс: зилбертс зилбертса
вентис: вентис вентиса
энциклопедия: энциклопедии
петерсонс: петерсонсом
мартынов: мартыновым
сюита: сюиту
заведение: заведениях
архивный: архивная
использовать: использующие
русский: русский
пожертвовать: пожертвовать
доступный: доступен
дарзиня: дарзиня
педагог: педагог педагоги
родиться: род родившиеся
олег: олега
занятие: занятий
знак: знак
профессор: профессор
считаться: считается
инструменталист: инструменталистов
некоммерческий: некоммерческой
учётный: учётную
событие: события
дитой: дитой
получить: получить
барсков: барскова
руководитель: руководитель
альбом: альбомы
директор: директор
натан: натана
короткий: короткий
число: числе
расширение: расширение
сообщество: сообщество
заявление: заявление
улдис: улдис
сюда: сюда
академия: академии академия
пространство: пространства
скачать: скачать
случай: случаях
среди: среди
май: мая
викимедиа: викимедиа
сольный: сольный
ленинградский: ленинградской
балет: балету
вклад: вклад
товарный: товарный
ответственность: ответственности
ряд: ряд
использование: использования
концерт: концерт
персональный: персональные
случайный: случайная
эмиль: эмиля
отредактировать: отредактирована
записать: записал
система: системе
три: трёх
ссылка: ссылка ссылки
персоналия: персоналии
сотрудничать: сотрудничал
категория: категории
скрытый: скрытые
сведение: сведения
композитор: композиторов
человек: человек
служебный: служебные
один: одним
сообщить: сообщить
другой: других
версия: версия
избранный: избранные
латыш: латыш
латышский: латышского
статистика: статистика
отдельный: отдельных
г: г
эмилс: эмилс
навигация: навигации навигация
лицензия: лицензии
отказ: отказ
витол: витола
ныне: ныне
июнь: июня
перейти: перейти
век: века
сохранение: сохранением
свободный: свободной
спрогис: спрогисом
указание: указанием
конфиденциальность: конфиденциальности
барабанщик: барабанщик
сотня: сотней
связанный: связанные
дата: дата
окончить: окончил
ингун: ингуна
общество: общества
певец: певцами
ещё: ещё
связаться: свяжитесь
поведение: поведения
кренберга: кренбергой
разработчик: разработчики
дополнительный: дополнительные
добавить: добавить
неизвестный: неизвестная
секция: секции
параметр: параметров
орден: ордена
изображение: изображений
воляк: воляком
сочинение: сочинений
цитировать: цитировать
архивировать: архивировано
примечание: примечания
организация: организации
игорь: игоря
академический: академические
зарегистрировать: зарегистрированный
впервые: впервые
фонд: фонд
политика: политика
мочь: могут
просмотр: просмотры
сайт: сайте
затем: затем
неопр: неопр
лолита: лолита
золото: золото
рождение: рождения
мартыньша: мартыньш
