мы: нами
вологодский: вологодской вологодском
болгария: болгария
название: названия
отказ: отказ
пожалуйста: пожалуйста
псковский: псковская
украина: украина
волость: волость
системеобсуждениевкладсоздать: системеобсуждениевкладсоздать
событияпожертвовать: событияпожертвовать
россия: россия
район: района районе
община: община общине
населить: населённом населённых
сообщить: сообщить
некрасовский: некрасовском
краснохолмский: краснохолмском
ржевский: ржевском
лицензия: лицензии
кодистория: кодистория
связаться: свяжитесь
указание: указанием
начало: начале
пространство: пространства
код: код
страницецитировать: страницецитировать
указывать: указывала
конаковский: конаковском
округ: округе
старосельский: старосельское
викимедиа: викимедиа
село: село
сюда: сюда
страница: страница страницы
свободный: свободной
страницыслужебный: страницыслужебные
статья: статьи статью
ссылка: ссылки ссылку
попасть: попали
энциклопедия: энциклопедии
читатьправитьправить: читатьправитьправить
некоммерческий: некоммерческой
статьяобсуждение: статьяобсуждение
тячевский: тячевском
московский: московской
содержание: содержание
ещё: ещё
конфиденциальность: конфиденциальности
поселение: поселение поселении
правкиновое: правкиновые
смотреть: см
озеро: озеро
конкретный: конкретном
дуть: дуло
состав: состав
персональный: персональные
локнянский: локнянская локнянском
викидать: викиданных
дулов: дулов
перейти: перейти
мочь: могут
русский: русский
условие: условий условия
чеховский: чеховском
страницасодержаниеизбрать: страницасодержаниеизбранные
также: также
навигация: навигации навигация
белосельский: белосельском
элемент: элемент
товарный: товарный
авторство: авторства
бежаницский: бежаницском
значение: значений значения
зарегистрировать: зарегистрированный
закарпатский: закарпатской
дуловый: дулово
википедия: википедии википедия
заглавный: заглавная
правкипостоянный: правкипостоянная
материал: материал
торжокский: торжокском
статьятекущий: статьятекущие
примечаниясписка: примечаниясписок
статьисообществофорумсправкасвежий: статьисообществофорумсправкасвежие
поведение: поведения
кук: куки
отредактировать: отредактирована
ошибкекак: ошибкекак
печать: печати
пункт: пункте пункты
вернуться: вернитесь
политика: политика
подберезинский: подберезинская
пошехонский: пошехонского
статьислучайный: статьислучайная
статистика: статистика
имя: имён
записьвойти: записьвойти
доступный: доступен
дополнительный: дополнительные
ярославский: ярославская ярославского
область: области область
организация: организации
сельский: сельское сельском
короткий: короткий
скачать: скачать
представиться: представились
последний: последний
случай: случаях
текст: текст
тверская: тверская
фонд: фонд
учётный: учётную
проект: проектах
алфавитустраница: алфавитустраницы
этот: эта
город: город
заявление: заявление
поиск: поиск поиску
страницуполучить: страницуполучить
деревня: деревня
сохранение: сохранением
уточнить: уточните
мобильный: мобильная
городской: городском
править: править
язык: языках
подробный: подробнее
разработчик: разработчики
знак: знак
кубенское: кубенское
одноимённый: одноимённых
описание: описание
сюдасвязанный: сюдасвязанные
отдельный: отдельных
участие: участие
стать: статей
другой: других
осташковский: осташковском
использование: использования
ответственность: ответственности
топоним: топоним
силистренский: силистренской
входить: входит
просмотр: просмотры
кодекс: кодекс
версия: версия
кирилловский: кирилловском
палкинский: палкинском
категория: категории
населённый: населённые
ссылкасведение: ссылкасведения
май: мая
источник: источник
инструмент: инструменты
действовать: действовать
