войти: войти вошла
тема: теме
вопрос: вопросом
начало: начале
сделать: сделал
описание: описание
авторство: авторства
аранжировка: аранжировке
концерт: концертах
материал: материал
поиск: поиск поиску
песня: песен песне песни песню песня
инструмент: инструменты
стиль: стиле
страница: страница странице страницу страницы
несмотря: несмотря
обращение: обращения
букк: букка букки
также: также
выпустить: выпустила выпущенная
мелроуза: мелроуза
брунзи: брунзи
представиться: представились
штат: штата
заглавный: заглавная заглавного
современник: современников
уайт: уайт уайта уайтом
текст: текст текста
назвать: назвав
кодекс: кодекс
нелепо: нелепо
контрапункт: контрапункте
причём: причём
указать: указан
мать: мать
биг: биг
сборник: сборник
настолько: настолько
использовать: использующие
записать: записал записала записали
верить: верю
посвятить: посвященных
событие: события
случай: случаях
трек: трека
дэйв: дэйв
статья: статьи статья
жена: жене
скрытый: скрытые
служебный: служебные
свой: своего своих
условие: условий условия
версия: версия
статистика: статистика
акустический: акустической
музыкант: музыканта
руководство: руководством
близкий: близки
миссисипи: миссисипи
возродиться: возродился
перейти: перейти
камин: камина
билл: билла
использоваться: используется
жанр: жанр жанре
англ: англ
альбом: альбом альбома альбоме
сон: снов
существенный: существенных
связаться: свяжитесь
создание: создания
певец: певец певца
кук: кука куки
продюсер: продюсер
один: одного одной
архивировать: архивировано
добавить: добавлено
отмечаться: отмечается
блюзовый: блюзового блюзовые блюзовых
раган: рагана
март: марта
фонд: фонд
глаз: глазах
мочь: могут можете
поздний: позже
навигация: навигации навигация
мысль: мысли
хотеть: хочу
год: год года годом году лет
осмеливаться: осмеливался
печально: печально
октябрь: октября
кавер: кавер
волшебный: волшебные
дебютный: дебютного
содержание: содержание
февраль: февраля
выйти: вышедшего
код: код
фарма: фарм
публика: публики
долгий: долгими
её: её
сказать: сказал
довольно: довольно
день: дней
этот: эта
фолковый: фолковых
беспокойный: беспокойной
забава: забавы
правка: правка правки
примечание: примечания примечаниях
ради: ради
немного: немного
новый: нового новые
джи: джи
назад: назад
алфавит: алфавиту
специально: специально
широкий: широкой
мелодический: мелодическая
русский: русский
пожертвовать: пожертвовать
умереть: умереть умру
парчмена: парчмен
язык: язык языках
место: место
некоммерческий: некоммерческой
попурри: попурри
находиться: находясь
расширение: расширение
сообщество: сообщество
роберт: роберт
продолжительный: продолжительное
заявление: заявление
сессия: сессии
вызвать: вызвала
ответственность: ответственности
персональный: персональные
отредактировать: отредактирована
британский: британская
линия: линия
система: системе
плант: плант
фолка: фолка
который: которая которые который
ссылка: ссылка ссылки
человек: человек
выглядеть: выгляжу
лирический: лирическими
сообщить: сообщить
избранный: избранные
википедия: википедии википедия
лейбл: лейбл лейбле
лицензия: лицензии
готовиться: готовлюсь
концертный: концертная концертный
лав: лав
ещё: ещё
ночь: ночами
сказочный: сказочная
отмечать: отмечает
отражать: отражал
задаваться: задаваться
вместе: вместе
бывший: бывшая
неопр: неопр
полагать: полагаю
править: править
известный: известной
действовать: действовать
подробный: подробнее
декабрь: декабря
происходить: происходила
ошибка: ошибке
пульсировать: пульсирует
уошборд: уошборд
смерть: смерти
прощать: прощай
исполнить: исполненного исполнил
художественный: художественной
баффи: баффи
заключение: заключения
сингл: сингл синглы
обсуждение: обсуждение
лестер: лестер лестера
последний: последний последняя
волна: волне
помимо: помимо
участие: участие
друг: друга
собираться: собираюсь
запись: записи запись
форум: форум
одноимённый: одноимённой
свидетель: свидетелем
блюзмена: блюзмена
создать: создать
имя: имён
тот: той
забить: забить
музыка: музыка музыки
качество: качеств качестве
печать: печати
постоянный: постоянная
букка: буккой
стать: стал стала
терять: теряют
страна: страна
ронк: ронк
викидать: викиданных
ван: ван
обложка: обложке
мелроуз: мелроуз
пространство: пространства
другой: другая другие другими других
независимый: независимый
знак: знак
получить: получить
товарный: товарный
сюда: сюда
скачать: скачать
сольный: сольный
оригинал: оригинала
вклад: вклад
музыкальный: музыкальную музыкальный
дельта: дельты
исполнение: исполнении исполнения
аккомпанемент: аккомпанемент
сведение: сведения
формат: формат
рисунок: рисунка
английский: английский
карьера: карьеру
насколько: насколько
написать: написана
июнь: июня
наследие: наследия
чувствовать: чувствует
два: двух
джой: джоя
относиться: относятся
цитировать: цитировать
плачущий: плачущими
группа: группа
композиция: композиции композиция
боб: боб боба
зарегистрировать: зарегистрированный
политика: политика
чикаго: чикаго
просмотр: просмотры
ребёнок: детей детях
длительность: длительность
голова: голову
начать: начал
блюз: блюз
тюрьма: тюрьме
оставлять: оставлять
американский: американский американского
свежий: свежие
смотреть: см
плакать: плачет
проект: проект проектах
справка: справка
сторона: сторона
идти: идти
элемент: элемент
доска: доске доски
дилан: дилан дилана
читать: читать
тед: тед
мы: нами
текущий: текущие
скоро: скоро
интерес: интерес интереса
звукорежиссёр: звукорежиссёра
история: история
время: время
три: трех
мобильный: мобильная
старый: старой
энциклопедия: энциклопедии
половина: половиной
выпуск: выпуска
доступный: доступен
стиральный: стиральной
энергия: энергией
вокал: вокал
умирать: умирает
ренессанс: ренессанса
пластинка: пластинки
источник: источник
должный: должен
родить: рождён
учётный: учётную
короткий: короткий
возобновлять: возобновлял
основать: основана
эли: эли
викимедиа: викимедиа
одиннадцать: одиннадцатью
традиционный: традиционный
использование: использования
ритмический: ритмического
случайный: случайная
знать: знаю
пока: пока
чак: чака
автор: автор
категория: категории
образ: образам
сэм: сэма
напролёт: напролёт
отдельный: отдельных
отказ: отказ
сохранение: сохранением
свободный: свободной
историк: историк
указание: указанием
конфиденциальность: конфиденциальности
сочинить: сочинена
спеть: спета
дата: дата
связанный: связанные
поведение: поведения
отдалиться: отдалился
число: числу
результат: результате
разработчик: разработчики
б: б
несколько: несколько
вид: виде
дополнительный: дополнительные
возрождение: возрождение
грампластинка: грампластинка
сыграть: сыграл
организация: организации
мрачный: мрачный
однако: однако
январь: января
позаимствовать: позаимствована
включить: включена
мой: моих
