фернс: фернс
войти: войти
часовня: часовнями
трим: трим
помочь: помогите
действовать: действовать
подробный: подробнее
статья: статьи статья
ошибка: ошибке
архитектурный: архитектурный
англиканский: англиканские англиканский англиканских англиканскому
эннискиллен: эннискиллен эннискиллене
описание: описание
дотла: дотла
авторство: авторства
яков: яковом
диоцез: диоцез диоцезе диоцезу
материал: материал
католический: католический католическое
заглавный: заглавная
собор: собор соборов соборы
заготовка: заготовка
содержание: содержание
поиск: поиск поиску
февраль: февраля
внешний: внешние
церковь: церкви церковь
архитектура: архитектура
правка: правка правки
обсуждение: обсуждение
кук: куки
свежий: свежие
смотреть: см
ссылка: ссылка ссылками ссылки
код: код
возвести: возведено
последний: последний последняя
стиль: стиле стиль
рафо: рафо
инструмент: инструменты
маккатасаид: маккатасаидом
справка: справка
новый: новые
страница: страница странице страницу страницы
тирон: тирон
здание: здание здании здания зданиями
килмор: килмор
макартан: макартан макартана
участие: участие
её: её
архитектор: архитектором
лимерик: лимерик
культовый: культовые
элемент: элемент
два: двумя двух
епископ: епископом
также: также
широта: ш
весь: всем
библиографический: библиографических
условие: условий условия
элфин: элфин
дублин: дублин дублина
запись: запись
тип: тип
читать: читать
нынешний: нынешнее
википедия: википедии википедия
представиться: представились
арма: арма армы
форум: форум
этот: эта
мы: нами
аббатство: аббатство аббатством
текущий: текущие
создать: создать
сооружение: сооружения
распоряжение: распоряжению
имя: имя имён
источник: источник источниками
текст: текст
кодекс: кодекс
графство: графстве
история: история
печать: печати
мак: мак
постоянный: постоянная
лисберн: лисберн
около: около
киллал: киллала
страна: страна
клонферт: клонферт
викисклад: викисклад викискладе
монастырь: монастыре монастырь
мобильный: мобильная
викидать: викиданных
год: года году
медиафайл: медиафайлы
алфавит: алфавиту
апрель: апреля
клойна: клойн
конфессия: конфессия
килдэр: килдэр
энциклопедия: энциклопедии
пространство: пространства
северный: северная северной
туам: туам
русский: русский
пожертвовать: пожертвовать
другой: другими других
доступный: доступен
святой: святого святой
шаблон: шаблона
язык: языках
ирландия: ирландии ирландия
знак: знак
считаться: считается
некоммерческий: некоммерческой
учётный: учётную
событие: события
церковный: церковном
получить: получить
килкенни: килкенни
передать: переданы
поведение: поведения
короткий: короткий
дополнить: дополнив
клохер: клохер клохера клохере
киллало: киллало
патрик: патрика
сообщество: сообщество
сюда: сюда
король: королём
карта: картами
скачать: скачать
случай: случаях
товарный: товарный
викимедиа: викимедиа
ответственность: ответственности
каиртинна: каиртинн
вклад: вклад
неоклассицизм: неоклассицизм неоклассицизма
великобритания: великобритания
использование: использования
персональный: персональные
случайный: случайная
каталог: каталогах
монахан: монахан
епархия: епархию епархия
основание: основания
находиться: находится
мартин: мартином
ресурс: ресурсы
отредактировать: отредактирована
система: системе
конфисковать: конфискованы
категория: категории
скрытый: скрытые
сведение: сведения
доход: доходы
служебный: служебные
сообщить: сообщить
англиканство: англиканство
версия: версия
избранный: избранные
объект: объекты
статистика: статистика
христианский: христианском
отдельный: отдельных
оригинал: оригиналом
навигация: навигации навигация
лицензия: лицензии
сгореть: сгорела
отказ: отказ
позапрошлый: позапрошлом
проект: проектах
джеймс: джеймсом
перейти: перейти
сохранение: сохранением
свободный: свободной
заявление: заявление
англ: англ
указание: указанием
конфиденциальность: конфиденциальности
провинция: провинция
каидти: кашел
храм: храм
слайго: слайго
дата: дата
связанный: связанные
деревня: деревне
ещё: ещё
связаться: свяжитесь
даунпатрик: даунпатрик
перестроить: перестроена
второй: второй
незавершённый: незавершённые
построить: построенные
снова: снова
разработчик: разработчики
дополнительный: дополнительные
олдлохлин: олдлохлин
это: это
мэтью: мэтью
цитировать: цитировать
примечание: примечания
белфаст: белфаст
вд: вд
основать: основал
лисмор: лисмор
географический: географические
организация: организации
вместе: вместе
освятить: освящена
название: названия
антропогенный: антропогенные
зарегистрировать: зарегистрированный
фонд: фонд
политика: политика
неоклассический: неоклассическом
дерри: дерри
дромор: дромор
уотерфорд: уотерфорд
просмотр: просмотры
мочь: могут
местоположение: местоположение
корк: корк
содержимое: содержимым
агео: агео
править: править
